ELEKTRICITEIT	ELEKTRICITEIT.bml
WG-1	WG-1.bml

1	1.sigml
10	10.sigml
11	11.sigml
12	12.sigml
13	13.sigml
14	14.sigml
15	15.sigml
16	16.sigml
17	17.sigml
18	18.sigml
19	19.sigml
2	2.sigml
20	20.sigml
21	21.sigml
22	22.sigml
23	23.sigml
24	24.sigml
25	25.sigml
26	26.sigml
27	27.sigml
28	28.sigml
29	29.sigml
3	3.sigml
30	30.sigml
31	31.sigml
32	32.sigml
33	33.sigml
34	34.sigml
35	35.sigml
36	36.sigml
37	37.sigml
38	38.sigml
39	39.sigml
4	4.sigml
40	40.sigml
41	41.sigml
42	42.sigml
43	43.sigml
44	44.sigml
45	45.sigml
46	46.sigml
47	47.sigml
48	48.sigml
49	49.sigml
5	5.sigml
50	50.sigml
51	51.sigml
6	6.sigml
60	60.sigml
61	61.sigml
62	62.sigml
63	63.sigml
64	64.sigml
65	65.sigml
66	66.sigml
67	67.sigml
68	68.sigml
69	69.sigml
7	7.sigml
70	70.sigml
71	71.sigml
72	72.sigml
73	73.sigml
74	74.sigml
75	75.sigml
76	76.sigml
77	77.sigml
78	78.sigml
79	79.sigml
8	8.sigml
80	80.sigml
81	81.sigml
82	82.sigml
83	83.sigml
84	84.sigml
85	85.sigml
86	86.sigml
87	87.sigml
88	88.sigml
89	89.sigml
9	9.sigml
90	90.sigml
91	91.sigml
92	92.sigml
93	93.sigml
94	94.sigml
95	95.sigml
96	96.sigml
97	97.sigml
98	98.sigml
99	99.sigml
A	A-SP.sigml
AA	AA-SP.sigml
AAH_IK_BEGRIJP_HET	AAH_IK_BEGRIJP_HET-SQ.sigml
AAIEN	AAIEN.sigml
AAN	AAN-CL{LICHT}.sigml
AANDACHT	AANDACHT.sigml
AANDOEN	AANDOEN-CL{LAMP}.sigml
AANDOEN	AANDOEN-CL{LICHT}.sigml
AANKLEDEN	AANKLEDEN.sigml
AANKOMEN	AANKOMEN-AM{ARRIVEREN}-CL{RIJTUIG}.sigml
AANKOMEN	AANKOMEN-AM{ARRIVEREN}-CL{VLIEGTUIG}.sigml
AANKOMEN	AANKOMEN-AM{GEWICHT}.sigml
AANKOMEN	AANKOMEN.sigml
AANKOMST	AANKOMST.sigml
AANLEGGEN	AANLEGGEN.sigml
AANPASSEN	AANPASSEN-AM{AAN_IETS}-DI{1_2}.sigml
AANPASSEN	AANPASSEN-AM{ALGEMEEN}.sigml
AANPRIJZEN	AANPRIJZEN.sigml
AANTAL	AANTAL.sigml
AANTIKKEN	AANTIKKEN.sigml
AANTREKKELIJK	AANTREKKELIJK.sigml
AANTREKKEN	AANTREKKEN-CL{JAS}.sigml
AANVAL	AANVAL.sigml
AANVALLEN	AANVALLEN-DI{1_2}.sigml
AANVALLEN	AANVALLEN-DI{1_3A}.sigml
AANVALLEN	AANVALLEN-DI{1_3B}.sigml
AANVALLEN	AANVALLEN-DI{2_1}.sigml
AANWEZIG	AANWEZIG-AM{NEGATIE}.sigml
AANWEZIG	AANWEZIG-GR.sigml
AANWEZIG	AANWEZIG.sigml
AANWIJZEN	AANWIJZEN.sigml
AARDAPPEL	AARDAPPEL.sigml
AARDAPPELPUREE	AARDAPPELPUREE.sigml
AARDBEI	AARDBEI.sigml
AARDE	AARDE-AM{GROND}.sigml
AARDE	AARDE-AM{WERELD}.sigml
AARDIG	AARDIG-AM{NIET_SLECHT}.sigml
AARDIG	AARDIG-AM{PERSOON}.sigml
ABONNEMENT	ABONNEMENT.sigml
ACCEPTEREN	ACCEPTEREN.sigml
ACHTER	ACHTER-AM{ACHTERNAAM}.sigml
ACHTER	ACHTER-AM{LOPEN}.sigml
ACHTER	ACHTER-AM{MIJ}.sigml
ACHTER	ACHTER-AM{OBJECT}.sigml
ACHTER	ACHTER-AM{ZIN}.sigml
ACHTERNAAM	ACHTERNAAM.sigml
ACHTERUITGAAN	ACHTERUITGAAN-AM{GEZONDHEID}.sigml
ACHT_UUR	ACHT_UUR-AM{TIJDSDUUR}.sigml
ACHT_UUR	ACHT_UUR-AM{TIJDSTIP}.sigml
ADEMEN	ADEMEN-AM{ADEMHALEN}.sigml
ADEMEN	ADEMEN-AM{INADEMEN}.sigml
ADEMEN	ADEMEN-AM{UITADEMEN}.sigml
ADEMHALEN	ADEMHALEN.sigml
ADEM_UITBLAZEN	ADEM_UITBLAZEN.sigml
ADRES	ADRES.sigml
ADVOCAAT	ADVOCAAT.sigml
AF	AF-AM{SPEL_PERSONEN}.sigml
AF	AF-AM{SPEL_PION}.sigml
AFDELING	AFDELING.sigml
AFDROGEN	AFDROGEN-AM{AFWAS}.sigml
AFDROGEN	AFDROGEN-AM{KIND}.sigml
AFDROGEN	AFDROGEN-AM{LICHAAM}.sigml
AFDRUKKEN	AFDRUKKEN.sigml
AFGELOPEN	AFGELOPEN-AM{DAGEN}.sigml
AFGELOPEN	AFGELOPEN-AM{EINDE}.sigml
AFGELOPEN	AFGELOPEN-AM{ONLANGS}.sigml
AFGELOPEN	AFGELOPEN-AM{VORIGE}.sigml
AFGEPRIJSD	AFGEPRIJSD.sigml
AFGESPOKEN	AFGESPOKEN.sigml
AFHANKELIJK	AFHANKELIJK-AM{IETS}.sigml
AFHANKELIJK	AFHANKELIJK-AM{PERSOON}.sigml
AFHOUDEN	AFHOUDEN.sigml
AFNEMEN	AFNEMEN-CL{BLOED}.sigml
AFPAKKEN	AFPAKKEN-DI{1_3}.sigml
AFPAKKEN	AFPAKKEN-DI{3_1}.sigml
AFPAKKEN	AFPAKKEN.sigml
AFSPRAAK	AFSPRAAK.sigml
AFSPREKEN	AFSPREKEN.sigml
AFWASBORSTEL	AFWASBORSTEL.sigml
AFWASSEN	AFWASSEN.sigml
AGENDA	AGENDA.sigml
AKELIG	AKELIG.sigml
AKKOORD	AKKOORD.sigml
AL	AL.sigml
ALARM	ALARM.sigml
ALDOOR	ALDOOR.sigml
ALINEAS	ALINEAS.sigml
ALLEEN	ALLEEN.sigml
ALLEMAAL	ALLEMAAL.sigml
ALLERGIE	ALLERGIE.sigml
ALLES	ALLES.sigml
ALLOCHTOON	ALLOCHTOON.sigml
ALS	ALS.sigml
ALSJEBLIEFT	ALSJEBLIEFT.sigml
ALSTUBLIEFT	ALSTUBLIEFT.sigml
ALTIJD	ALTIJD-AM{ANDERS}.sigml
ALTIJD	ALTIJD.sigml
ALVLEESKLIER	ALVLEESKLIER.sigml
ALWEER	ALWEER.sigml
AMBULANCE	AMBULANCE.sigml
AMSTERDAM	AMSTERDAM.sigml
ANDERE	ANDERE.sigml
ANDERE_KEER	ANDERE_KEER-SQ.sigml
ANDERHALF	ANDERHALF.sigml
ANDERS	ANDERS.sigml
ANDERSOM	ANDERSOM.sigml
ANDIJVIE	ANDIJVIE.sigml
ANGSTIG	ANGSTIG.sigml
ANNULEREN	ANNULEREN.sigml
ANTWOORD	ANTWOORD.sigml
ANTWOORDAPPARAAT	ANTWOORDAPPARAAT.sigml
APOTHEEK	APOTHEEK.sigml
APPARAAT	APPARAAT.sigml
APPEL	APPEL.sigml
APPELFLAP	APPELFLAP.sigml
APPELMOES	APPELMOES.sigml
APPELSAP	APPELSAP.sigml
APPELSTROOP	APPELSTROOP.sigml
APRIL	APRIL.sigml
ARM	ARM-AM{LEDEMAAT}.sigml
ARM	ARM-AM{ZIJN}.sigml
ARMOEDIG	ARMOEDIG.sigml
ARTS	ARTS.sigml
ASIEL	ASIEL.sigml
ASIELZOEKER	ASIELZOEKER.sigml
AU	AU.sigml
AUDICIEN	AUDICIEN.sigml
AUDIOGRAM	AUDIOGRAM.sigml
AUDIOLOGIE	AUDIOLOGIE.sigml
AUDIOLOOG	AUDIOLOOG.sigml
AUGUSTUS	AUGUSTUS.sigml
AUTO	AUTO.sigml
AUTOBUS	AUTOBUS.sigml
AUTOMAAT	AUTOMAAT-AM{AUTO}.sigml
AUTOMATISCH	AUTOMATISCH-AM{TECHNIEK}.sigml
AUTOMATISCH	AUTOMATISCH.sigml
AUTOMATISCHE	AUTOMATISCHE.sigml
AUTORIJDEN	AUTORIJDEN.sigml
AVOND	AVOND.sigml
B	B-SP.sigml
BAAN	BAAN-AM{WERK}.sigml
BAARD	BAARD.sigml
BAAS	BAAS.sigml
BABBELEN	BABBELEN-CL{GEBARENTAAL}.sigml
BABY	BABY.sigml
BABYSITTEN	BABYSITTEN.sigml
BAD	BAD.sigml
BADJAS	BADJAS.sigml
BADKAMER	BADKAMER.sigml
BADKUIP	BADKUIP.sigml
BADPAK	BADPAK.sigml
BAGAGE	BAGAGE.sigml
BAKKEN	BAKKEN.sigml
BAKKER	BAKKER.sigml
BAL	BAL.sigml
BALEN	BALEN.sigml
BALLON	BALLON.sigml
BANAAN	BANAAN.sigml
BANG	BANG.sigml
BANK	BANK-AM{GELD}.sigml
BANK	BANK-AM{MEUBEL}.sigml
BANKETLETTER	BANKETLETTER.sigml
BANKETSTAAF	BANKETSTAAF.sigml
BARET	BARET.sigml
BASIS	BASIS.sigml
BASISELEMENT	BASISELEMENT.sigml
BATTERIJ	BATTERIJ.sigml
BB	BB-SP.sigml
BED	BED.sigml
BEDANKEN	BEDANKEN.sigml
BEDENKEN	BEDENKEN.sigml
BEDOELEN	BEDOELEN.sigml
BEDOELING	BEDOELING.sigml
BEDRIJF	BEDRIJF.sigml
BEEKJE	BEEKJE.sigml
BEEN	BEEN.sigml
BEETJE	BEETJE.sigml
BEGELEIDEN	BEGELEIDEN.sigml
BEGELEIDER	BEGELEIDER.sigml
BEGELEIDING	BEGELEIDING.sigml
BEGIN	BEGIN.sigml
BEGINNEN	BEGINNEN.sigml
BEGRAFENIS	BEGRAFENIS.sigml
BEGRAVEN	BEGRAVEN.sigml
BEGRIJPEN	BEGRIJPEN.sigml
BEHA	BEHA.sigml
BEHEERSEN	BEHEERSEN.sigml
BEHEERSING	BEHEERSING.sigml
BEHOEDEN	BEHOEDEN.sigml
BEHOEDZAAM	BEHOEDZAAM.sigml
BEINVLOEDEN	BEINVLOEDEN.sigml
BEKEND	BEKEND.sigml
BEKENDE	BEKENDE.sigml
BEKENDMAKEN	BEKENDMAKEN.sigml
BEKER	BEKER.sigml
BEL	BEL.sigml
BELANGRIJK	BELANGRIJK.sigml
BELASTING	BELASTING.sigml
BELEDIGD	BELEDIGD.sigml
BELEEFD	BELEEFD.sigml
BELLEN	BELLEN-CL{HOREND}.sigml
BELLEN	BELLEN.sigml
BELOVEN	BELOVEN.sigml
BEMOEIEN	BEMOEIEN-AM{NEGATIE}.sigml
BEMOEIEN	BEMOEIEN.sigml
BENAUWDHEID	BENAUWDHEID.sigml
BENEDEN	BENEDEN.sigml
BENIEUWD	BENIEUWD.sigml
BENZINE	BENZINE.sigml
BEOORDELEN	BEOORDELEN.sigml
BEPROEVEN	BEPROEVEN.sigml
BEREIKEN	BEREIKEN.sigml
BERG	BERG.sigml
BESCHERMEN	BESCHERMEN.sigml
BESCHUIT	BESCHUIT.sigml
BESLISSEN	BESLISSEN.sigml
BESLISSING	BESLISSING.sigml
BESLUIT	BESLUIT.sigml
BESLUITEN	BESLUITEN.sigml
BESTAAN	BESTAAN.sigml
BETALEN	BETALEN.sigml
BETEKENEN	BETEKENEN.sigml
BETEKENIS	BETEKENIS.sigml
BETER	BETER-AM{GEZOND}.sigml
BETER	BETER.sigml
BETOVEREN	BETOVEREN.sigml
BETRAPPEN	BETRAPPEN.sigml
BEURT	BEURT.sigml
BEVALLEN	BEVALLEN-AM{BABY}.sigml
BEVALLEN	BEVALLEN-AM{PRETTIG}.sigml
BEVRIJDING	BEVRIJDING.sigml
BEVRIJDINGSDAG	BEVRIJDINGSDAG.sigml
BEWEGEN	BEWEGEN.sigml
BEWEGING	BEWEGING.sigml
BEWIJS	BEWIJS.sigml
BEWIJZEN	BEWIJZEN.sigml
BEZIG	BEZIG.sigml
BEZOEK	BEZOEK.sigml
BEZOEKEN	BEZOEKEN.sigml
BEZORGD	BEZORGD.sigml
BIDDEN	BIDDEN-CL{CHRISTENEN}.sigml
BIDDEN	BIDDEN-CL{JODEN}.sigml
BIDDEN	BIDDEN-CL{MOSLIMS}.sigml
BIJ	BIJ-AM{EXTRA}.sigml
BIJ	BIJ-AM{INSECT}.sigml
BIJBEL	BIJBEL.sigml
BIJNA	BIJNA.sigml
BIJVOORBEELD	BIJVOORBEELD.sigml
BIKINI	BIKINI.sigml
BIL	BIL.sigml
BILLEN	BILLEN.sigml
BINNEN	BINNEN.sigml
BINNENKORT	BINNENKORT.sigml
BINNEN_GAAN	BINNEN_GAAN-SQ.sigml
BIOSCOOP	BIOSCOOP.sigml
BIPS	BIPS.sigml
BLAAS	BLAAS.sigml
BLAD	BLAD.sigml
BLADZIJDE	BLADZIJDE.sigml
BLAFFEN	BLAFFEN.sigml
BLANK	BLANK-AM{HUIDSKLEUR}.sigml
BLAUW	BLAUW.sigml
BLAUWE_PLEK	BLAUWE_PLEK-SQ.sigml
BLEEK_ZIEN	BLEEK_ZIEN-SQ.sigml
BLIJ	BLIJ.sigml
BLIJKEN	BLIJKEN.sigml
BLIJVEN	BLIJVEN.sigml
BLIK	BLIK.sigml
BLIND	BLIND.sigml
BLOED	BLOED.sigml
BLOEDDRUK	BLOEDDRUK.sigml
BLOEDNEUS	BLOEDNEUS.sigml
BLOEDPRIKKEN	BLOEDPRIKKEN.sigml
BLOED_AFNEMEN	BLOED_AFNEMEN-SQ.sigml
BLOEIEN	BLOEIEN.sigml
BLOES	BLOES.sigml
BLOKKEN	BLOKKEN.sigml
BLOND	BLOND-AM{HAARKLEUR}.sigml
BLOOT	BLOOT.sigml
BLOUSE	BLOUSE.sigml
BLOZEN	BLOZEN.sigml
BOEF	BOEF.sigml
BOEK	BOEK.sigml
BOEKENKAST	BOEKENKAST.sigml
BOER	BOER.sigml
BOERDERIJ	BOERDERIJ.sigml
BOERIN	BOERIN.sigml
BOETE	BOETE.sigml
BOFFEN	BOFFEN.sigml
BONEN	BONEN.sigml
BOODSCHAPPEN	BOODSCHAPPEN.sigml
BOODSCHAPPENLIJST	BOODSCHAPPENLIJST.sigml
BOOM	BOOM.sigml
BOOMSTAM	BOOMSTAM.sigml
BOOS	BOOS-AM{KINDERGEBAAR}.sigml
BOOS	BOOS.sigml
BOOT	BOOT.sigml
BORD	BORD-AM{SERVIES}.sigml
BORST	BORST.sigml
BOS	BOS.sigml
BOT	BOT.sigml
BOTER	BOTER.sigml
BOTERHAM	BOTERHAM.sigml
BOTSEN	BOTSEN.sigml
BOTSING	BOTSING.sigml
BOUWEN	BOUWEN.sigml
BOUWNIJVERHEID	BOUWNIJVERHEID.sigml
BOVEN	BOVEN.sigml
BRABANT	BRABANT.sigml
BRAND	BRAND.sigml
BRANDEN	BRANDEN.sigml
BRANDWEER	BRANDWEER.sigml
BREED	BREED.sigml
BREEDTE	BREEDTE.sigml
BREKEN	BREKEN.sigml
BRENGEN	BRENGEN.sigml
BRIEF	BRIEF.sigml
BRIEVENBUS	BRIEVENBUS.sigml
BRIL	BRIL.sigml
BROEDER	BROEDER.sigml
BROEK	BROEK.sigml
BROER	BROER.sigml
BROMMER	BROMMER.sigml
BROOD	BROOD.sigml
BROODTROMMEL	BROODTROMMEL.sigml
BRUG	BRUG.sigml
BRUGGETJE	BRUGGETJE.sigml
BRUID	BRUID.sigml
BRUIDEGOM	BRUIDEGOM.sigml
BRUIN	BRUIN-AM{HUIDSKLEUR}.sigml
BRUIN	BRUIN.sigml
BRUTAAL	BRUTAAL.sigml
BUGALOW	BUGALOW.sigml
BUIK	BUIK.sigml
BUIKKRAMP	BUIKKRAMP.sigml
BUIKPIJN	BUIKPIJN.sigml
BUITEN	BUITEN.sigml
BULT	BULT.sigml
BUNGALOW	BUNGALOW.sigml
BUREAU	BUREAU.sigml
BUREN	BUREN.sigml
BUS	BUS.sigml
BUSCHAUFFEUR	BUSCHAUFFEUR.sigml
BUURMAN	BUURMAN.sigml
BUURT	BUURT.sigml
BUURVROUW	BUURVROUW.sigml
C	C-SP.sigml
CADEAU	CADEAU.sigml
CAMPING	CAMPING.sigml
CARAVAN	CARAVAN.sigml
CAVIA	CAVIA.sigml
CC	CC-SP.sigml
CENTRUM	CENTRUM.sigml
CHAMPAGNE	CHAMPAGNE.sigml
CHARMANT	CHARMANT.sigml
CHAUFFEUR	CHAUFFEUR.sigml
CHIPS	CHIPS.sigml
CHOCOLADE	CHOCOLADE.sigml
CI	CI.sigml
CIJFER	CIJFER.sigml
CIJFERS	CIJFERS.sigml
CITROEN	CITROEN.sigml
COMMANDEREN	COMMANDEREN.sigml
COMMUNICATIE	COMMUNICATIE.sigml
COMPLIMENT	COMPLIMENT.sigml
COMPUTER	COMPUTER.sigml
CONCREET	CONCREET.sigml
CONTACT	CONTACT.sigml
CONTINU	CONTINU.sigml
CONTROLE	CONTROLE.sigml
CONTROLEREN	CONTROLEREN.sigml
CORONA	CORONA.sigml
CORONA_B	CORONA_B.sigml
CREMATIE	CREMATIE.sigml
CRITISCH	CRITISCH.sigml
CROCUS	CROCUS.sigml
CROISSANT	CROISSANT.sigml
CULTUUR	CULTUUR.sigml
CURSUS	CURSUS.sigml
D	D-SP.sigml
DAAROM	DAAROM.sigml
DAG	DAG-AM{GROET}.sigml
DAG	DAG.sigml
DAGEN	DAGEN.sigml
DAGERAAD	DAGERAAD.sigml
DAN	DAN.sigml
DANSEN	DANSEN.sigml
DARMEN	DARMEN.sigml
DD	DD-SP.sigml
DECEMBER	DECEMBER.sigml
DEKEN	DEKEN.sigml
DENKEN	DENKEN.sigml
DEUR	DEUR.sigml
DING	DING.sigml
DINSDAG	DINSDAG.sigml
DIT	DIT.sigml
DOCENT	DOCENT.sigml
DOCHTER	DOCHTER.sigml
DOEI	DOEI.sigml
DOEL	DOEL.sigml
DOEN	DOEN.sigml
DOEN_ALSOF	DOEN_ALSOF-SQ.sigml
DOKTER	DOKTER.sigml
DONDERDAG	DONDERDAG.sigml
DONKER_WORDEN	DONKER_WORDEN-SQ.sigml
DOOF	DOOF.sigml
DOOF_WORDEN	DOOF_WORDEN-SQ.sigml
DOORGAAN	DOORGAAN.sigml
DORST	DORST.sigml
DOUCHE	DOUCHE.sigml
DOUCHEN	DOUCHEN.sigml
DRAMA	DRAMA.sigml
DRANKJE	DRANKJE.sigml
DRIE_UUR	DRIE_UUR-AM{TIJDSDUUR}.sigml
DRIE_UUR	DRIE_UUR-AM{TIJDSTIP}.sigml
DRINKEN	DRINKEN-CL{HOND}.sigml
DRINKEN	DRINKEN.sigml
DROOG	DROOG.sigml
DRUKKEN	DRUKKEN.sigml
DRUKKEND	DRUKKEND.sigml
DRUPPELS	DRUPPELS.sigml
DUIZEND	DUIZEND.sigml
E	E-SP.sigml
ECHO	ECHO.sigml
ECHTPAAR	ECHTPAAR.sigml
EE	EE-SP.sigml
EEKHOORN	EEKHOORN.sigml
EENS	EENS.sigml
EEN_UUR	EEN_UUR-AM{TIJDSDUUR}.sigml
EEN_UUR	EEN_UUR-AM{TIJDSTIP}.sigml
EERDER	EERDER.sigml
EERLIJK	EERLIJK.sigml
EERSTE	EERSTE.sigml
EI	EI.sigml
EIND	EIND.sigml
ELF	ELF.sigml
ELLENDIG	ELLENDIG.sigml
EMAIL	EMAIL.sigml
EMAILEN	EMAILEN-DI{1_2}.sigml
EMAILEN	EMAILEN-DI{2_1}.sigml
ERG_ZIEK	ERG_ZIEK-SQ.sigml
ER_GENOEG_VAN_HEBBEN	ER_GENOEG_VAN_HEBBEN-SQ.sigml
ETEN	ETEN-AM{NEGATIE}.sigml
ETEN	ETEN.sigml
EURO	EURO.sigml
EVEN	EVEN.sigml
F	F-SP.sigml
FABRIEK	FABRIEK.sigml
FANTASIE	FANTASIE.sigml
FAVORIET	FAVORIET.sigml
FEBRUARI	FEBRUARI.sigml
FEEST	FEEST.sigml
FF	FF-SP.sigml
FIETS	FIETS.sigml
FILM	FILM.sigml
FLUITJE_VAN_EEN_CENT	FLUITJE_VAN_EEN_CENT-SQ.sigml
FOTO	FOTO.sigml
FOTOGRAFEREN	FOTOGRAFEREN.sigml
FOUT	FOUT.sigml
FRIET	FRIET.sigml
G	G-SP.sigml
GAAN	GAAN-DI{1_2}.sigml
GAAN	GAAN-DI{1_3A}.sigml
GAAN	GAAN.sigml
GALBLAAS	GALBLAAS.sigml
GANG	GANG.sigml
GARAGE	GARAGE.sigml
GAT	GAT.sigml
GEBAREN	GEBAREN.sigml
GEBEURD	GEBEURD.sigml
GEBEUREN	GEBEUREN.sigml
GEBOREN	GEBOREN.sigml
GEBOUW	GEBOUW.sigml
GEBRUIKEN	GEBRUIKEN.sigml
GEDEELD_DOOR	GEDEELD_DOOR-SQ.sigml
GEDRAG	GEDRAG.sigml
GEDRAGEN	GEDRAGEN.sigml
GEDULD	GEDULD.sigml
GEDULDIG	GEDULDIG.sigml
GEEL	GEEL.sigml
GEEN_VERSTAND_HEBBEN	GEEN_VERSTAND_HEBBEN-SQ.sigml
GEHANDICAPT	GEHANDICAPT.sigml
GEHEEL	GEHEEL-AM{TIJD}.sigml
GEHEIM	GEHEIM.sigml
GEHOORAPPARAAT	GEHOORAPPARAAT.sigml
GEHOORZAAM	GEHOORZAAM.sigml
GEHOORZAMEN	GEHOORZAMEN.sigml
GEIRRITEERD	GEIRRITEERD.sigml
GEIT	GEIT.sigml
GEKNEUSD	GEKNEUSD.sigml
GELD	GELD.sigml
GELDERLAND	GELDERLAND.sigml
GELIJK_HEBBEN	GELIJK_HEBBEN-SQ.sigml
GELOOF	GELOOF.sigml
GELOVEN	GELOVEN.sigml
GELUK	GELUK.sigml
GEMAKKELIJK	GEMAKKELIJK.sigml
GEMEENTE	GEMEENTE.sigml
GENIETEN	GENIETEN.sigml
GEOPEND	GEOPEND.sigml
GEPRIKKELD	GEPRIKKELD.sigml
GESLOTEN	GESLOTEN.sigml
GESPREKKEN	GESPREKKEN.sigml
GESPROKEN	GESPROKEN.sigml
GESTOORD	GESTOORD.sigml
GETROUWD	GETROUWD.sigml
GEVAARLIJK	GEVAARLIJK.sigml
GEVEN	GEVEN-CL{KLEIN}-DI{1_2}.sigml
GEVEN	GEVEN-CL{MIDDELGROOT}-DI{1_2}.sigml
GEVEN	GEVEN-CL{MIDDELGROOT}-DI{1_3A}.sigml
GEVEN	GEVEN-CL{PLAT}-DI{1_3A}.sigml
GEVEN	GEVEN-DI{1_2}.sigml
GEVEN	GEVEN-DI{1_3A}.sigml
GEVEN	GEVEN-DI{1_3B}.sigml
GEVEN	GEVEN-DI{3A_3B}.sigml
GEVEN	GEVEN-DI{3B_1}.sigml
GEVOEL	GEVOEL.sigml
GEVOLG	GEVOLG.sigml
GEWOND	GEWOND.sigml
GEWOON	GEWOON.sigml
GG	GG-SP.sigml
GOD	GOD.sigml
GOED	GOED.sigml
GOEDKOOP	GOEDKOOP.sigml
GOOIEN	GOOIEN.sigml
GOUD	GOUD.sigml
GRAAG	GRAAG.sigml
GRACHT	GRACHT.sigml
GRAFIEK	GRAFIEK.sigml
GRAMMATICA	GRAMMATICA.sigml
GRAP	GRAP.sigml
GRAS	GRAS.sigml
GRATIS	GRATIS.sigml
GRIEP	GRIEP.sigml
GROEIEN	GROEIEN.sigml
GROEN	GROEN.sigml
GROENTE	GROENTE.sigml
GROENTENBOER	GROENTENBOER.sigml
GROEP	GROEP.sigml
GROETEN_DOEN	GROETEN_DOEN-SQ.sigml
GROND	GROND.sigml
GRONINGEN	GRONINGEN.sigml
GROOT	GROOT.sigml
GROOTVADER	GROOTVADER.sigml
GULDEN	GULDEN.sigml
GYM	GYM.sigml
GYMNASTIEK	GYMNASTIEK.sigml
H	H-SP.sigml
HAAN	HAAN.sigml
HAAR	HAAR.sigml
HAAS	HAAS.sigml
HAAST	HAAST.sigml
HAGELSLAG	HAGELSLAG.sigml
HALEN	HALEN-AM{EXAMEN}.sigml
HALEN	HALEN-DI{3A_1}.sigml
HALEN	HALEN.sigml
HALF	HALF.sigml
HALF_UUR	HALF_UUR-SQ.sigml
HALLO	HALLO.sigml
HALS	HALS.sigml
HALTE	HALTE.sigml
HAMER	HAMER.sigml
HAMSTER	HAMSTER.sigml
HAND	HAND.sigml
HANDDOEK	HANDDOEK.sigml
HANDDRUK	HANDDRUK.sigml
HANDENARBEID	HANDENARBEID.sigml
HANDICAP	HANDICAP.sigml
HANDSCHOENEN	HANDSCHOENEN.sigml
HANDTEKENING	HANDTEKENING.sigml
HANDVORM	HANDVORM.sigml
HAND_GEVEN	HAND_GEVEN-SQ.sigml
HAPJE	HAPJE.sigml
HARD	HARD.sigml
HARK	HARK.sigml
HARKEN	HARKEN.sigml
HART	HART.sigml
HATEN	HATEN-DI{2_1}.sigml
HATEN	HATEN.sigml
HEBBEN	HEBBEN-AM{NEGATIE}.sigml
HEBBEN	HEBBEN.sigml
HECHTEN	HECHTEN.sigml
HEER	HEER.sigml
HEET	HEET.sigml
HEIMWEE	HEIMWEE.sigml
HEK	HEK.sigml
HEKEL	HEKEL.sigml
HEKS	HEKS.sigml
HELIKOPTER	HELIKOPTER.sigml
HELPEN	HELPEN-DI{1_2}.sigml
HELPEN	HELPEN.sigml
HEMD	HEMD.sigml
HEMEL	HEMEL.sigml
HEMELVAART	HEMELVAART.sigml
HERFST	HERFST.sigml
HERHALEN	HERHALEN.sigml
HERHALING	HERHALING.sigml
HERINNEREN	HERINNEREN.sigml
HERINNERING	HERINNERING.sigml
HERSENEN	HERSENEN.sigml
HETZELFDE	HETZELFDE.sigml
HET_LAAT_ME_KOUD	HET_LAAT_ME_KOUD-SQ.sigml
HET_MAAKT_MIJ_NIETS_UIT	HET_MAAKT_MIJ_NIETS_UIT-SQ.sigml
HIER	HIER.sigml
HOE	HOE.sigml
HOED	HOED.sigml
HOESTEN	HOESTEN.sigml
HOEVEEL	HOEVEEL.sigml
HOEVEN	HOEVEN-AM{NIET}.sigml
HOE_BESTAAT_HET	HOE_BESTAAT_HET-SQ.sigml
HOE_KOMT_DAT	HOE_KOMT_DAT-SQ.sigml
HOE_LAAT	HOE_LAAT-SQ.sigml
HOE_LANG	HOE_LANG-AM{TIJD}.sigml
HOND	HOND.sigml
HONDERD	HONDERD.sigml
HONGER	HONGER.sigml
HONING	HONING.sigml
HOOFD	HOOFD.sigml
HOOFDPIJN	HOOFDPIJN.sigml
HOOG	HOOG.sigml
HOOGTE	HOOGTE.sigml
HOOI	HOOI.sigml
HOPEN	HOPEN.sigml
HOREN	HOREN.sigml
HOREND	HOREND.sigml
HORLOGE	HORLOGE.sigml
HOUDEN_VAN	HOUDEN_VAN-SQ.sigml
HOUDING	HOUDING.sigml
HOUT	HOUT.sigml
HOU_OP	HOU_OP-SQ.sigml
HUILEN	HUILEN.sigml
HUIS	HUIS.sigml
HUISWERK	HUISWERK.sigml
HUREN	HUREN.sigml
HUWELIJK	HUWELIJK.sigml
I	I-SP.sigml
IDEE	IDEE.sigml
IEDEREEN	IEDEREEN.sigml
IEMAND	IEMAND.sigml
IETS	IETS.sigml
II	II-SP.sigml
IJVERIG	IJVERIG.sigml
IK_ZIT_VOL	IK_ZIT_VOL-SQ.sigml
IN	IN.sigml
INADEMEN	INADEMEN.sigml
INBEELDEN	INBEELDEN.sigml
INDEX_3A	INDEX_3A-GR.sigml
INDEX_3B	INDEX_3B-GR.sigml
INDEX_HAND	INDEX_HAND-GR.sigml
INDEX_VEEL	INDEX_VEEL-GR.sigml
INDIVIDU	INDIVIDU.sigml
INDUSTRIE	INDUSTRIE.sigml
INFORMATIE	INFORMATIE-DI{2_1}.sigml
INFORMATIE	INFORMATIE.sigml
INFORMEREN	INFORMEREN.sigml
INFUUS	INFUUS.sigml
INGANG	INGANG.sigml
INGEWIKKELD	INGEWIKKELD.sigml
INHOUD	INHOUD.sigml
INJECTIE	INJECTIE.sigml
INKOMEN	INKOMEN.sigml
INSTAPPEN	INSTAPPEN.sigml
INTERESSANT	INTERESSANT.sigml
INTERNAAT	INTERNAAT.sigml
INTERNET	INTERNET.sigml
INVLOED	INVLOED.sigml
IN_DE_WAR	IN_DE_WAR-SQ.sigml
IN_GAAN	IN_GAAN-SQ.sigml
IN_SLAAP_VALLEN	IN_SLAAP_VALLEN-SQ.sigml
IN_VERBAND_MET	IN_VERBAND_MET-SQ.sigml
IN_VERWACHTING	IN_VERWACHTING-SQ.sigml
J	J-SP.sigml
JA	JA.sigml
JAAR	JAAR.sigml
JALOERS	JALOERS.sigml
JAMMER	JAMMER.sigml
JANUARI	JANUARI.sigml
JARIG	JARIG.sigml
JAS	JAS.sigml
JA_NOU_EN	JA_NOU_EN-SQ.sigml
JEUK	JEUK.sigml
JONG	JONG.sigml
JONGEN	JONGEN.sigml
JOURNAAL	JOURNAAL.sigml
JUFFROUW	JUFFROUW.sigml
JULI	JULI.sigml
JULLIE	JULLIE.sigml
JUNI	JUNI.sigml
K	K-SP.sigml
KAAL	KAAL.sigml
KAARS	KAARS.sigml
KAART	KAART.sigml
KAARTJE	KAARTJE.sigml
KAAS	KAAS.sigml
KAASSCHAAF	KAASSCHAAF.sigml
KABOUTER	KABOUTER.sigml
KACHEL	KACHEL.sigml
KALENDER	KALENDER.sigml
KALKOEN	KALKOEN.sigml
KALM	KALM.sigml
KAM	KAM.sigml
KAMER	KAMER.sigml
KAMPEREN	KAMPEREN.sigml
KANO	KANO.sigml
KANTOOR	KANTOOR.sigml
KAN_ME_NIET_ZOVEEL_SCHELEN	KAN_ME_NIET_ZOVEEL_SCHELEN-SQ.sigml
KAPOT	KAPOT.sigml
KAPPER	KAPPER.sigml
KAR	KAR.sigml
KARAKTER	KARAKTER.sigml
KARNEMELK	KARNEMELK.sigml
KARTON	KARTON.sigml
KASSA	KASSA.sigml
KAST	KAST.sigml
KASTANJE	KASTANJE.sigml
KASTEEL	KASTEEL.sigml
KATTENVOER	KATTENVOER.sigml
KAUWGUM	KAUWGUM.sigml
KEEPER	KEEPER.sigml
KEER	KEER.sigml
KEIZER	KEIZER.sigml
KEIZERIN	KEIZERIN.sigml
KELDER	KELDER.sigml
KENNEN	KENNEN.sigml
KENNIS	KENNIS-AM{INFORMATIE}.sigml
KENNIS	KENNIS-AM{PERSOON}.sigml
KERK	KERK.sigml
KERMIS	KERMIS.sigml
KERSTBAL	KERSTBAL.sigml
KERSTBOOM	KERSTBOOM.sigml
KERSTFEEST	KERSTFEEST.sigml
KERSTMIS	KERSTMIS.sigml
KERSTSTER	KERSTSTER.sigml
KETEL	KETEL.sigml
KEUKEN	KEUKEN.sigml
KEURIG	KEURIG.sigml
KIEZEN	KIEZEN.sigml
KIJKEN	KIJKEN.sigml
KIKKER	KIKKER.sigml
KILO	KILO.sigml
KILOMETER	KILOMETER.sigml
KIN	KIN.sigml
KIND	KIND.sigml
KINDERACHTIG	KINDERACHTIG.sigml
KINDERBOERDERIJ	KINDERBOERDERIJ.sigml
KIP	KIP.sigml
KK	KK-SP.sigml
KLAAR	KLAAR.sigml
KLACHT	KLACHT.sigml
KLACHTEN	KLACHTEN.sigml
KLAS	KLAS.sigml
KLASLOKAAL	KLASLOKAAL.sigml
KLASSEASSISTENT	KLASSEASSISTENT.sigml
KLEIN	KLEIN.sigml
KLEINKIND	KLEINKIND.sigml
KLEREN	KLEREN.sigml
KLETSEN	KLETSEN-AM{GEBARENTAAL}.sigml
KLETSEN	KLETSEN-AM{SPREKEN}.sigml
KLEUR	KLEUR.sigml
KLEURBOEK	KLEURBOEK.sigml
KLEUREN	KLEUREN.sigml
KLEURPOTLOOD	KLEURPOTLOOD.sigml
KLEUTER	KLEUTER.sigml
KLIKKEN	KLIKKEN.sigml
KLIMMEN	KLIMMEN.sigml
KLIMREK	KLIMREK.sigml
KLOK	KLOK.sigml
KLOPPEN	KLOPPEN-AM{NEGATIE}.sigml
KLOPPEN	KLOPPEN.sigml
KNAP	KNAP-AM{KINDERGEBAAR}.sigml
KNAP	KNAP.sigml
KNIE	KNIE.sigml
KNIJPEN	KNIJPEN.sigml
KNIPPEN	KNIPPEN.sigml
KNOPEN	KNOPEN.sigml
KNUFFEL	KNUFFEL.sigml
KNUFFELBEER	KNUFFELBEER.sigml
KNUFFELEN	KNUFFELEN.sigml
KNUTSELEN	KNUTSELEN.sigml
KOE	KOE.sigml
KOEKEPAN	KOEKEPAN.sigml
KOEKJE	KOEKJE.sigml
KOELKAST	KOELKAST.sigml
KOFFER	KOFFER.sigml
KOFFIE	KOFFIE.sigml
KOFFIEZETAPPARAAT	KOFFIEZETAPPARAAT.sigml
KOK	KOK.sigml
KOKEN	KOKEN-CL{VLOEISTOF}.sigml
KOKEN	KOKEN.sigml
KOM	KOM.sigml
KOMEN	KOMEN.sigml
KOMENDE_TIJD	KOMENDE_TIJD-SQ.sigml
KOMKOMMER	KOMKOMMER.sigml
KONIJN	KONIJN.sigml
KONING	KONING.sigml
KONINGIN	KONINGIN.sigml
KONINGINNEDAG	KONINGINNEDAG.sigml
KOOL	KOOL.sigml
KOORTS	KOORTS.sigml
KOORTSTHERMOMETER	KOORTSTHERMOMETER.sigml
KOPEN	KOPEN.sigml
KOPIEREN	KOPIEREN.sigml
KOPJE	KOPJE.sigml
KOPPIG	KOPPIG.sigml
KOPTELEFOON	KOPTELEFOON.sigml
KORT	KORT-AM{TIJD}.sigml
KORT	KORT.sigml
KORT_GELEDEN	KORT_GELEDEN-SQ.sigml
KOSTEN	KOSTEN.sigml
KOUD	KOUD-AM{HEBBEN}.sigml
KOUD	KOUD-AM{ZIJN}.sigml
KOUS	KOUS.sigml
KRAAN	KRAAN.sigml
KRAMP	KRAMP.sigml
KRAMPEND	KRAMPEND.sigml
KRANT	KRANT.sigml
KRENTENBOL	KRENTENBOL.sigml
KRENTENBROOD	KRENTENBROOD.sigml
KRIBBE	KRIBBE.sigml
KRIEBELEN	KRIEBELEN.sigml
KRIJGEN	KRIJGEN.sigml
KRITISCH	KRITISCH.sigml
KROKET	KROKET.sigml
KROKUS	KROKUS.sigml
KROM	KROM.sigml
KROON	KROON.sigml
KRUIPEN	KRUIPEN.sigml
KRUISPUNT	KRUISPUNT.sigml
KRUIWAGEN	KRUIWAGEN.sigml
KRULLEN	KRULLEN.sigml
KUIKEN	KUIKEN.sigml
KUNNEN	KUNNEN.sigml
KUS	KUS.sigml
KUSJE	KUSJE.sigml
KWAAD	KWAAD.sigml
KWARTIER	KWARTIER.sigml
KWART_OVER	KWART_OVER-SQ.sigml
KWART_VOOR	KWART_VOOR-SQ.sigml
KWAST	KWAST.sigml
KWIJT	KWIJT.sigml
L	L-SP.sigml
LAAG	LAAG.sigml
LAARS	LAARS.sigml
LAAT	LAAT.sigml
LAATDOOF	LAATDOOF.sigml
LAATSTE	LAATSTE.sigml
LAATSTE_TIJD	LAATSTE_TIJD-SQ.sigml
LAAT_MAAR	LAAT_MAAR-SQ.sigml
LACHEN	LACHEN.sigml
LAKEN	LAKEN.sigml
LAMP	LAMP.sigml
LAMPION	LAMPION.sigml
LAND	LAND.sigml
LANDBOUW	LANDBOUW.sigml
LANG	LANG-AM{PERSOON}.sigml
LANG	LANG-AM{TIJD}.sigml
LANGDRADIG	LANGDRADIG.sigml
LANGZAAM	LANGZAAM.sigml
LAST	LAST.sigml
LASTIG	LASTIG.sigml
LATER	LATER-AM{KORT}.sigml
LATER	LATER-AM{LANG}.sigml
LAWAAI	LAWAAI.sigml
LEEG	LEEG-AM{OBJECT}.sigml
LEEG	LEEG-AM{RUIMTE}.sigml
LEERLING	LEERLING.sigml
LEESVERTELLEN	LEESVERTELLEN.sigml
LEGER	LEGER.sigml
LEGO	LEGO.sigml
LEKKER	LEKKER.sigml
LENEN	LENEN.sigml
LENGTE	LENGTE.sigml
LENTE	LENTE.sigml
LEPEL	LEPEL.sigml
LERAAR	LERAAR.sigml
LEREN	LEREN.sigml
LES	LES.sigml
LESGEVEN	LESGEVEN.sigml
LETTER	LETTER.sigml
LEUK	LEUK.sigml
LEVEN	LEVEN.sigml
LEVER	LEVER.sigml
LEZEN	LEZEN.sigml
LICHAAM	LICHAAM.sigml
LICHT	LICHT-AM{GEWICHT}.sigml
LICHT	LICHT-AM{WORDEN}.sigml
LICHTBEL	LICHTBEL.sigml
LICHTBLAUW	LICHTBLAUW.sigml
LICHTBRUIN	LICHTBRUIN.sigml
LICHTJE	LICHTJE.sigml
LID	LID.sigml
LIEDJE	LIEDJE.sigml
LIEF	LIEF.sigml
LIEFDE	LIEFDE.sigml
LIEGEN	LIEGEN.sigml
LIFT	LIFT.sigml
LIGGEN	LIGGEN.sigml
LIJF	LIJF.sigml
LIJKEN	LIJKEN.sigml
LIJKEN_OP	LIJKEN_OP-SQ.sigml
LIJM	LIJM.sigml
LIJN	LIJN.sigml
LIJST	LIJST.sigml
LIKKEN	LIKKEN.sigml
LIMBURG	LIMBURG.sigml
LIMONADE	LIMONADE.sigml
LIMONADESIROOP	LIMONADESIROOP.sigml
LINKS	LINKS.sigml
LIP	LIP.sigml
LITER	LITER.sigml
LL	LL-SP.sigml
LOGEREN	LOGEREN.sigml
LOGISCH	LOGISCH.sigml
LOGOPEDIE	LOGOPEDIE.sigml
LOGOPEDIST	LOGOPEDIST.sigml
LOL	LOL.sigml
LOLLY	LOLLY.sigml
LONGEN	LONGEN.sigml
LOPEN	LOPEN.sigml
LOSLATEN	LOSLATEN.sigml
LUCHT	LUCHT.sigml
LUI	LUI.sigml
LUIER	LUIER.sigml
LUISTEREN	LUISTEREN-AM{NEGATIE}.sigml
LUISTEREN	LUISTEREN.sigml
LUKKEN	LUKKEN-AM{NEGATIE}.sigml
LUKKEN	LUKKEN.sigml
LULLIG	LULLIG.sigml
LUSTEN	LUSTEN.sigml
M	M-SP.sigml
MAAG	MAAG.sigml
MAAKT_NIET_UIT	MAAKT_NIET_UIT-SQ.sigml
MAAL	MAAL.sigml
MAAN	MAAN.sigml
MAAND	MAAND.sigml
MAANDAG	MAANDAG.sigml
MAANDEN	MAANDEN.sigml
MAANDVERBAND	MAANDVERBAND.sigml
MAAR	MAAR.sigml
MAART	MAART.sigml
MAAT	MAAT.sigml
MACARONI	MACARONI.sigml
MACHINE	MACHINE.sigml
MAGER	MAGER.sigml
MAKEN	MAKEN.sigml
MAKKELIJK	MAKKELIJK.sigml
MAKKIE	MAKKIE.sigml
MAL	MAL.sigml
MAMA	MAMA.sigml
MAN	MAN-AM{GESLACHT}.sigml
MAN	MAN-AM{PARTNER}.sigml
MANDARIJN	MANDARIJN.sigml
MANIER	MANIER.sigml
MANUEEL	MANUEEL.sigml
MARMOT	MARMOT.sigml
MATERIAAL	MATERIAAL.sigml
MAXIMA	MAXIMA.sigml
MAYONAISE	MAYONAISE.sigml
MEDELIJDEN	MEDELIJDEN.sigml
MEDICIJN	MEDICIJN.sigml
MEDICIJNEN	MEDICIJNEN.sigml
MEEBRENGEN	MEEBRENGEN.sigml
MEEDOEN	MEEDOEN.sigml
MEELEVEN	MEELEVEN.sigml
MEENEMEN	MEENEMEN.sigml
MEER	MEER-AM{WATER}.sigml
MEER	MEER.sigml
MEEST	MEEST.sigml
MEESTER	MEESTER.sigml
MEEVALLEN	MEEVALLEN.sigml
MEI	MEI.sigml
MEISJE	MEISJE.sigml
MELDEN	MELDEN.sigml
MELK	MELK.sigml
MENING	MENING.sigml
MENS	MENS.sigml
MERKEN	MERKEN.sigml
MES	MES.sigml
METEEN	METEEN.sigml
METER	METER.sigml
METRO	METRO.sigml
MEUBELS	MEUBELS.sigml
MIDDAG	MIDDAG.sigml
MIDDEN	MIDDEN.sigml
MIJTER	MIJTER.sigml
MILIEU	MILIEU.sigml
MILJARD	MILJARD.sigml
MILJOEN	MILJOEN.sigml
MILLENIUM	MILLENIUM.sigml
MIMIEK	MIMIEK.sigml
MIN	MIN.sigml
MINDER	MINDER.sigml
MINDER_WORDEN	MINDER_WORDEN-SQ.sigml
MINST	MINST.sigml
MINUTEN	MINUTEN.sigml
MINUUT	MINUUT.sigml
MIS	MIS.sigml
MISSCHIEN	MISSCHIEN.sigml
MISSELIJK	MISSELIJK.sigml
MISSEN	MISSEN.sigml
MIST	MIST.sigml
MM	MM-SP.sigml
MODDER	MODDER.sigml
MODERN	MODERN.sigml
MOE	MOE.sigml
MOEDER	MOEDER.sigml
MOEILIJK	MOEILIJK.sigml
MOETEN	MOETEN.sigml
MOET_GEWOON	MOET_GEWOON-SQ.sigml
MOGEN	MOGEN-AM{NEGATIE}.sigml
MOGEN	MOGEN.sigml
MOND	MOND.sigml
MOOI	MOOI.sigml
MOP	MOP.sigml
MOPPEREN	MOPPEREN.sigml
MORGEN	MORGEN.sigml
MOTOR	MOTOR.sigml
MOTREGEN	MOTREGEN.sigml
MUG	MUG.sigml
MUIS	MUIS.sigml
MUST	MUST.sigml
MUTS	MUTS.sigml
MUUR	MUUR.sigml
N	N-SP.sigml
NA	NA.sigml
NAAIEN	NAAIEN-CL{HAND}.sigml
NAAIEN	NAAIEN-CL{MACHINE}.sigml
NAAKT	NAAKT.sigml
NAALD	NAALD.sigml
NAAM	NAAM.sigml
NAAR_BED	NAAR_BED-SQ.sigml
NAAR_BINNEN	NAAR_BINNEN-SQ.sigml
NAAST	NAAST.sigml
NACHT	NACHT.sigml
NACHTMERRIE	NACHTMERRIE.sigml
NADEEL	NADEEL.sigml
NADENKEN	NADENKEN.sigml
NAME	NAME.sigml
NARCIS	NARCIS.sigml
NARCOSE	NARCOSE.sigml
NASI	NASI.sigml
NAT	NAT.sigml
NEDERLAND	NEDERLAND.sigml
NEDERLANDS	NEDERLANDS.sigml
NEDERLANDS_MET_GEBAREN	NEDERLANDS_MET_GEBAREN-SQ.sigml
NEEF	NEEF.sigml
NEERLEGGEN	NEERLEGGEN-CL{BAL}.sigml
NEERLEGGEN	NEERLEGGEN-CL{BEER}.sigml
NEERLEGGEN	NEERLEGGEN-CL{BLOK}.sigml
NEERLEGGEN	NEERLEGGEN-CL{BOEK}.sigml
NEGATIEF	NEGATIEF.sigml
NEGEN_UUR	NEGEN_UUR-AM{TIJDSDUUR}.sigml
NEGEN_UUR	NEGEN_UUR-AM{TIJDSTIP}.sigml
NEGEREN	NEGEREN.sigml
NEK	NEK.sigml
NERGENS	NERGENS.sigml
NERVEUS	NERVEUS.sigml
NEST	NEST.sigml
NET	NET.sigml
NETJES	NETJES.sigml
NEUS	NEUS.sigml
NICHT	NICHT.sigml
NIEMAND	NIEMAND.sigml
NIEREN	NIEREN.sigml
NIETS	NIETS.sigml
NIET_HELEMAAL_GOED	NIET_HELEMAAL_GOED-SQ.sigml
NIET_LEKKER_VOELEN	NIET_LEKKER_VOELEN-SQ.sigml
NIET_MEER	NIET_MEER-SQ.sigml
NIEUW	NIEUW.sigml
NIEUWJAARSDAG	NIEUWJAARSDAG.sigml
NIEUWS	NIEUWS.sigml
NIEUWSGIERIG	NIEUWSGIERIG.sigml
NIEZEN	NIEZEN.sigml
NIKS	NIKS.sigml
NN	NN-SP.sigml
NODIG	NODIG.sigml
NOEN	NOEN.sigml
NOG	NOG.sigml
NOG_NIET	NOG_NIET-SQ.sigml
NON	NON-MANUEEL_DEEL-SQ.sigml
NOOIT	NOOIT.sigml
NOORD	NOORD-HOLLAND.sigml
NOORD	NOORD.sigml
NORMAAL	NORMAAL.sigml
NOVEMBER	NOVEMBER.sigml
NU	NU.sigml
NUMMER	NUMMER.sigml
O	O-SP.sigml
OCHTEND	OCHTEND.sigml
OEFENEN	OEFENEN.sigml
OF	OF.sigml
OH_ZIT_DAT_ZO	OH_ZIT_DAT_ZO-SQ.sigml
OK	OK.sigml
OKTOBER	OKTOBER.sigml
OLIEBOL	OLIEBOL.sigml
OMA	OMA.sigml
OMDAT	OMDAT.sigml
OMGAAN	OMGAAN-AM{MET}.sigml
OMGEVING	OMGEVING.sigml
OMHOOG	OMHOOG.sigml
OMKEREN	OMKEREN-CL{AUTO}.sigml
OMKEREN	OMKEREN-CL{BOEK}.sigml
OMKEREN	OMKEREN-CL{LIGGEND_PERSOON}.sigml
OMKEREN	OMKEREN-CL{LOPEND_PERSOON}.sigml
OMKEREN	OMKEREN-CL{PUZZELSTUKJE}.sigml
OMLAAG	OMLAAG.sigml
OMVALLEN	OMVALLEN-CL{AUTO}.sigml
OMVALLEN	OMVALLEN-CL{BEKER}.sigml
OMVALLEN	OMVALLEN-CL{BOEK}.sigml
OM_DE_BEURT	OM_DE_BEURT-SQ.sigml
OM_DE_TWEE_DAGEN	OM_DE_TWEE_DAGEN-SQ.sigml
OM_DE_TWEE_JAAR	OM_DE_TWEE_JAAR-SQ.sigml
OM_DE_TWEE_MAANDEN	OM_DE_TWEE_MAANDEN-SQ.sigml
OM_DE_TWEE_WEKEN	OM_DE_TWEE_WEKEN-SQ.sigml
ONAFGEBROKEN	ONAFGEBROKEN.sigml
ONDERBROEK	ONDERBROEK.sigml
ONDERDRUKKEN	ONDERDRUKKEN-CL{PIJN}.sigml
ONDERTITELING	ONDERTITELING.sigml
ONDERWERP	ONDERWERP.sigml
ONDERWIJS	ONDERWIJS.sigml
ONDERZOEK	ONDERZOEK.sigml
ONDERZOEKEN	ONDERZOEKEN.sigml
ONDEUGEND	ONDEUGEND.sigml
ONGEHOORZAAM	ONGEHOORZAAM.sigml
ONGELUK	ONGELUK.sigml
ONGEVEER	ONGEVEER.sigml
ONKRUID	ONKRUID.sigml
ONMIDDELLIJK	ONMIDDELLIJK.sigml
ONMOGELIJK	ONMOGELIJK.sigml
ONS	ONS-AM{GEWICHT}.sigml
ONSCHULDIG	ONSCHULDIG.sigml
ONTHOUDEN	ONTHOUDEN.sigml
ONTMOETEN	ONTMOETEN.sigml
ONTWERP	ONTWERP.sigml
ONVOLDOENDE	ONVOLDOENDE.sigml
ONWEER	ONWEER.sigml
ONZEKER	ONZEKER.sigml
OO	OO-SP.sigml
OOG	OOG.sigml
OOK	OOK.sigml
OOM	OOM.sigml
OOR	OOR.sigml
OORLOG	OORLOG.sigml
OORSTUKJE	OORSTUKJE.sigml
OORZAAK	OORZAAK.sigml
OOST	OOST.sigml
OP	OP-AM{CLITIC}-DI{1_2}.sigml
OP	OP-AM{CLITIC}-DI{1_3A}.sigml
OP	OP-AM{CLITIC}-DI{1_3B}.sigml
OP	OP-AM{CLITIC}-DI{2_1}.sigml
OP	OP-AM{CLITIC}-DI{2_3A}.sigml
OP	OP-AM{CLITIC}-DI{2_3B}.sigml
OP	OP-AM{CLITIC}-DI{3A_1}.sigml
OP	OP-AM{CLITIC}-DI{3A_2}.sigml
OP	OP-AM{CLITIC}-DI{3A_3B}.sigml
OP	OP-AM{CLITIC}-DI{3B_1}.sigml
OP	OP-AM{CLITIC}-DI{3B_2}.sigml
OP	OP-AM{CLITIC}-DI{3B_3A}.sigml
OP	OP-AM{EIGENSCHAP}.sigml
OP	OP-AM{VOORZETSEL}-CL{BOTERHAM}.sigml
OP	OP-AM{VOORZETSEL}-CL{PAPIER}.sigml
OPA	OPA.sigml
OPDRACHT	OPDRACHT.sigml
OPEN	OPEN-CL{BOEK}.sigml
OPEN	OPEN-CL{BRUG}.sigml
OPEN	OPEN-CL{DEUR}.sigml
OPEN	OPEN-CL{OGEN}.sigml
OPEN	OPEN.sigml
OPENDOEN	OPENDOEN-CL{DEUR}.sigml
OPENMAKEN	OPENMAKEN.sigml
OPERATIE	OPERATIE.sigml
OPGELUCHT	OPGELUCHT.sigml
OPGEWONDEN	OPGEWONDEN.sigml
OPHALEN	OPHALEN.sigml
OPLEIDING	OPLEIDING.sigml
OPLOSSEN	OPLOSSEN.sigml
OPLOSSING	OPLOSSING.sigml
OPMAKEN	OPMAKEN-CL{BED}.sigml
OPNIEUW	OPNIEUW.sigml
OPPASSEN	OPPASSEN.sigml
OPPERDEPOP	OPPERDEPOP.sigml
OPRUIMEN	OPRUIMEN.sigml
OPSCHEPPEN	OPSCHEPPEN.sigml
OPSCHEPPER	OPSCHEPPER.sigml
OPSCHIETEN	OPSCHIETEN.sigml
OPTICIEN	OPTICIEN.sigml
OPVOEDEN	OPVOEDEN.sigml
OPVOEDING	OPVOEDING.sigml
OPZETTEN	OPZETTEN.sigml
OP_TIJD	OP_TIJD-SQ.sigml
ORALE_COMPONENT	ORALE_COMPONENT-SQ.sigml
ORANJE	ORANJE.sigml
ORGANISATIE	ORGANISATIE.sigml
ORGANISEREN	ORGANISEREN.sigml
OUD	OUD.sigml
OUDER	OUDER.sigml
OUDERS	OUDERS.sigml
OUDJAAR	OUDJAAR.sigml
OUDSTE	OUDSTE-AM{DINGEN}.sigml
OUDSTE	OUDSTE-AM{MENSEN}.sigml
OUD_EN_NIEUW	OUD_EN_NIEUW-SQ.sigml
OVEN	OVEN.sigml
OVER	OVER-AM{REST}.sigml
OVER	OVER-AM{TIJD}.sigml
OVER	OVER.sigml
OVERDAG	OVERDAG.sigml
OVERGEVEN	OVERGEVEN.sigml
OVERHEMD	OVERHEMD.sigml
OVERIJSSEL	OVERIJSSEL.sigml
OVERLEDEN	OVERLEDEN.sigml
OVERLIJDEN	OVERLIJDEN.sigml
OVERMORGEN	OVERMORGEN.sigml
OVERSTEKEN	OVERSTEKEN.sigml
OVERSTUUR	OVERSTUUR.sigml
OVER_ACHT_UUR	OVER_ACHT_UUR-SQ.sigml
OVER_DRIE_JAAR	OVER_DRIE_JAAR-SQ.sigml
OVER_DRIE_MAANDEN	OVER_DRIE_MAANDEN-SQ.sigml
OVER_DRIE_UUR	OVER_DRIE_UUR-SQ.sigml
OVER_DRIE_WEKEN	OVER_DRIE_WEKEN-SQ.sigml
OVER_EEN_JAAR	OVER_EEN_JAAR-SQ.sigml
OVER_EEN_MAAND	OVER_EEN_MAAND-SQ.sigml
OVER_EEN_PAAR_MINUTEN	OVER_EEN_PAAR_MINUTEN-SQ.sigml
OVER_EEN_TIJDJE	OVER_EEN_TIJDJE-SQ.sigml
OVER_EEN_UUR	OVER_EEN_UUR-SQ.sigml
OVER_EEN_WEEK	OVER_EEN_WEEK-SQ.sigml
OVER_NEGEN_UUR	OVER_NEGEN_UUR-SQ.sigml
OVER_TIEN_UUR	OVER_TIEN_UUR-SQ.sigml
OVER_TWEE_JAAR	OVER_TWEE_JAAR-SQ.sigml
OVER_TWEE_MAANDEN	OVER_TWEE_MAANDEN-SQ.sigml
OVER_TWEE_UUR	OVER_TWEE_UUR-SQ.sigml
OVER_TWEE_WEKEN	OVER_TWEE_WEKEN-SQ.sigml
OVER_VIER_UUR	OVER_VIER_UUR-SQ.sigml
OVER_VIJF_UUR	OVER_VIJF_UUR-SQ.sigml
OVER_ZES_UUR	OVER_ZES_UUR-SQ.sigml
OVER_ZEVEN_UUR	OVER_ZEVEN_UUR-SQ.sigml
P	P-SP.sigml
PAARD	PAARD.sigml
PAARDRIJDEN	PAARDRIJDEN.sigml
PAARS	PAARS.sigml
PAASHAAS	PAASHAAS.sigml
PADDESTOEL	PADDESTOEL.sigml
PAGINA	PAGINA.sigml
PAKJESAVOND	PAKJESAVOND.sigml
PAKKEN	PAKKEN-CL{BAL}.sigml
PAKKEN	PAKKEN-CL{STOEL}.sigml
PAKKEN	PAKKEN.sigml
PAKKET	PAKKET.sigml
PALMORIENTATIE	PALMORIENTATIE.sigml
PALM_OMHOOG	PALM_OMHOOG-GR.sigml
PAN	PAN.sigml
PANIEK	PANIEK.sigml
PANNENKOEK	PANNENKOEK.sigml
PANTY	PANTY.sigml
PAP	PAP.sigml
PAPA	PAPA.sigml
PAPIER	PAPIER.sigml
PAPRIKA	PAPRIKA.sigml
PARAPLU	PARAPLU.sigml
PARDON	PARDON.sigml
PARK	PARK.sigml
PARKEREN	PARKEREN.sigml
PASEN	PASEN.sigml
PASSEN	PASSEN-AM{BIJ_ELKAAR}.sigml
PASSEN	PASSEN-CL{KLEDING}.sigml
PAS_OP	PAS_OP-SQ.sigml
PATAT	PATAT.sigml
PATIENT	PATIENT.sigml
PAUS	PAUS.sigml
PAUW	PAUW.sigml
PAUZE	PAUZE.sigml
PECH	PECH.sigml
PEER	PEER.sigml
PEN	PEN.sigml
PENIS	PENIS.sigml
PEPER	PEPER.sigml
PERIODE	PERIODE.sigml
PERONGELUK	PERONGELUK.sigml
PERSONEEL	PERSONEEL.sigml
PERSONEN	PERSONEN.sigml
PERSOON	PERSOON.sigml
PERZIK	PERZIK.sigml
PESTEN	PESTEN.sigml
PET	PET.sigml
PEUTER	PEUTER.sigml
PEUTERSPEELZAAL	PEUTERSPEELZAAL.sigml
PIEKEREN	PIEKEREN.sigml
PIEMEL	PIEMEL.sigml
PIJN	PIJN.sigml
PINDA	PINDA.sigml
PINDAKAAS	PINDAKAAS.sigml
PINKSTEREN	PINKSTEREN.sigml
PITTIG	PITTIG-AM{ETEN}.sigml
PIZZA	PIZZA.sigml
PLAATS	PLAATS.sigml
PLAFOND	PLAFOND.sigml
PLAGEN	PLAGEN.sigml
PLAKKEN	PLAKKEN.sigml
PLAN	PLAN.sigml
PLANT	PLANT.sigml
PLAS	PLAS.sigml
PLASSEN	PLASSEN.sigml
PLASTIC	PLASTIC.sigml
PLEISTER	PLEISTER.sigml
PLEZIER	PLEZIER.sigml
PLOTSDOOF	PLOTSDOOF.sigml
PLOTSELING	PLOTSELING.sigml
PLUIM	PLUIM.sigml
PLUKKEN	PLUKKEN-CL{BLOEMEN}.sigml
PLUKKEN	PLUKKEN-CL{FRUIT}.sigml
PO	PO.sigml
POEP	POEP.sigml
POEPEN	POEPEN.sigml
POES	POES.sigml
POLDER	POLDER.sigml
POLIKLINIEK	POLIKLINIEK.sigml
POLITIE	POLITIE.sigml
POLITIEAGENT	POLITIEAGENT.sigml
POND	POND.sigml
POP	POP.sigml
POPULAIR	POPULAIR.sigml
PORTEMONNEE	PORTEMONNEE.sigml
POSITIEF	POSITIEF.sigml
POST	POST.sigml
POSTBODE	POSTBODE.sigml
POSTKANTOOR	POSTKANTOOR.sigml
POSTZEGEL	POSTZEGEL.sigml
POT	POT.sigml
POTJE	POTJE.sigml
POTLOOD	POTLOOD.sigml
PP	PP-SP.sigml
PRACHTIG	PRACHTIG.sigml
PRATEN	PRATEN.sigml
PRATEN_OVER	PRATEN_OVER-SQ.sigml
PRECIES	PRECIES.sigml
PREI	PREI.sigml
PRETTIG	PRETTIG.sigml
PRIJS	PRIJS.sigml
PRIK	PRIK.sigml
PRIKKEN	PRIKKEN-CL{INSECT}.sigml
PRIKLIMONADE	PRIKLIMONADE.sigml
PRIMA	PRIMA.sigml
PRINCIPE	PRINCIPE.sigml
PRINS	PRINS.sigml
PRINSES	PRINSES.sigml
PRIORITEIT	PRIORITEIT.sigml
PRIVE	PRIVE.sigml
PROBEREN	PROBEREN.sigml
PROEF	PROEF.sigml
PROEVEN	PROEVEN.sigml
PROFESSOR	PROFESSOR.sigml
PROVINCIE	PROVINCIE.sigml
PUDDING	PUDDING.sigml
PUNT	PUNT.sigml
PUNTENSLIJPER	PUNTENSLIJPER.sigml
PUZZEL	PUZZEL.sigml
PUZZELEN	PUZZELEN.sigml
PYAMA	PYAMA.sigml
Q	Q-SP.sigml
QQ	QQ-SP.sigml
QUARANTAINE	QUARANTAINE.sigml
R	R-SP.sigml
RAAK	RAAK.sigml
RAAM	RAAM.sigml
RAAM_ZEMEN	RAAM_ZEMEN-SQ.sigml
RAAR	RAAR.sigml
RADEN	RADEN.sigml
RADIO	RADIO.sigml
RAMADAN	RAMADAN.sigml
RAMP	RAMP.sigml
RANJA	RANJA.sigml
RAPPORT	RAPPORT-AM{ONDERZOEK}.sigml
RAPPORT	RAPPORT-AM{SCHOOL}.sigml
REACTIE	REACTIE.sigml
REAGEREN	REAGEREN-CL{LICHAMELIJK}.sigml
REAGEREN	REAGEREN-CL{MONDELING}.sigml
REALISEREN	REALISEREN.sigml
RECEPT	RECEPT.sigml
RECHTBANK	RECHTBANK.sigml
RECHTER	RECHTER.sigml
RECHTS	RECHTS.sigml
RECHT_HEBBEN_OP	RECHT_HEBBEN_OP-SQ.sigml
RECLAME	RECLAME.sigml
REDDEN	REDDEN.sigml
REGEL	REGEL.sigml
REGELEN	REGELEN.sigml
REGELMATIG	REGELMATIG.sigml
REGEN	REGEN.sigml
REGENBOOG	REGENBOOG.sigml
REGENEN	REGENEN.sigml
REGENPLAS	REGENPLAS.sigml
REGERING	REGERING.sigml
REIS	REIS.sigml
REIZEN	REIZEN.sigml
REKENEN	REKENEN.sigml
REKENING_HOUDEN	REKENING_HOUDEN-SQ.sigml
RELATIE	RELATIE-AM{ROMANTISCH}.sigml
RELATIE	RELATIE-AM{ZAKELIJK}.sigml
RELATIE	RELATIE.sigml
REMMEN	REMMEN.sigml
RENNEN	RENNEN.sigml
REPAREREN	REPAREREN.sigml
REPETEREN	REPETEREN.sigml
RESERVEREN	RESERVEREN.sigml
RESPECT	RESPECT.sigml
RESPECTEREN	RESPECTEREN.sigml
REST	REST-AM{ETEN}.sigml
RESTAURANT	RESTAURANT.sigml
RESULTAAT	RESULTAAT.sigml
REUS	REUS.sigml
REVALIDATIE	REVALIDATIE.sigml
RIDDER	RIDDER.sigml
RIEM	RIEM.sigml
RIET	RIET.sigml
RIJ	RIJ.sigml
RIJDEN	RIJDEN.sigml
RIJK	RIJK.sigml
RIJLES	RIJLES.sigml
RIJP	RIJP.sigml
RIJST	RIJST.sigml
RING	RING.sigml
RITS	RITS.sigml
RIVIER	RIVIER.sigml
ROEPEN	ROEPEN-DI{1_3A}.sigml
ROEPEN	ROEPEN-DI{1_3B}.sigml
ROEPEN	ROEPEN-DI{2_1}.sigml
ROEPEN	ROEPEN-DI{2_3A}.sigml
ROEPEN	ROEPEN-DI{2_3B}.sigml
ROEPEN	ROEPEN.sigml
ROEREN	ROEREN.sigml
ROGGEBROOD	ROGGEBROOD.sigml
ROK	ROK.sigml
ROKEN	ROKEN.sigml
ROLLEN	ROLLEN-CL{BAL}.sigml
ROLSCHAATSEN	ROLSCHAATSEN.sigml
ROMMEL	ROMMEL.sigml
ROND	ROND-AM{TIJD}.sigml
ROOD	ROOD.sigml
ROOS	ROOS.sigml
ROSE	ROSE.sigml
ROTTERDAM	ROTTERDAM.sigml
ROZE	ROZE.sigml
RR	RR-SP.sigml
RUBBER	RUBBER.sigml
RUG	RUG.sigml
RUGZAK	RUGZAK.sigml
RUIKEN	RUIKEN.sigml
RUILEN	RUILEN.sigml
RUIMTE	RUIMTE-AM{OMGEVING}.sigml
RUNDVLEES	RUNDVLEES.sigml
RUST	RUST.sigml
RUSTGEBAAR	RUSTGEBAAR.sigml
RUZIE	RUZIE.sigml
S	S-SP.sigml
SALARIS	SALARIS.sigml
SAMEN	SAMEN.sigml
SAMENVATTEN	SAMENVATTEN.sigml
SAMENVATTING	SAMENVATTING.sigml
SAMENWERKEN	SAMENWERKEN.sigml
SAMENWONEN	SAMENWONEN-AM{HUISGENOTEN}.sigml
SAMENWONEN	SAMENWONEN-AM{RELATIE}.sigml
SAUS	SAUS.sigml
SCAN	SCAN.sigml
SCHAAFWOND	SCHAAFWOND.sigml
SCHAAL	SCHAAL.sigml
SCHAAP	SCHAAP.sigml
SCHAAR	SCHAAR.sigml
SCHAATSEN	SCHAATSEN.sigml
SCHADUW	SCHADUW.sigml
SCHAKEN	SCHAKEN.sigml
SCHAMEN	SCHAMEN.sigml
SCHATTEN	SCHATTEN.sigml
SCHEET	SCHEET.sigml
SCHEIDEN	SCHEIDEN.sigml
SCHELDEN	SCHELDEN.sigml
SCHELP	SCHELP.sigml
SCHEP	SCHEP.sigml
SCHEPPEN	SCHEPPEN.sigml
SCHEREN	SCHEREN-CL{APPARAAT}.sigml
SCHEREN	SCHEREN-CL{HAND}.sigml
SCHERP	SCHERP-AM{ETEN}.sigml
SCHERP	SCHERP.sigml
SCHEUR	SCHEUR.sigml
SCHEUREN	SCHEUREN.sigml
SCHIETEN	SCHIETEN-CL{DOELPUNT}.sigml
SCHIETEN	SCHIETEN-CL{WAPEN}.sigml
SCHIJNEN	SCHIJNEN-CL{LAMP}.sigml
SCHIJNEN	SCHIJNEN-CL{ZON}.sigml
SCHIJT_HEBBEN_AAN	SCHIJT_HEBBEN_AAN-SQ.sigml
SCHILDEREN	SCHILDEREN.sigml
SCHILDERIJ	SCHILDERIJ.sigml
SCHILDKLIER	SCHILDKLIER.sigml
SCHILLEN	SCHILLEN.sigml
SCHIPHOL	SCHIPHOL.sigml
SCHITTEREN	SCHITTEREN.sigml
SCHITTEREND	SCHITTEREND.sigml
SCHOEN	SCHOEN.sigml
SCHOMMEL	SCHOMMEL.sigml
SCHOMMELEN	SCHOMMELEN.sigml
SCHOOL	SCHOOL-AM{SLECHTHORENDE}.sigml
SCHOOL	SCHOOL.sigml
SCHOOLARTS	SCHOOLARTS.sigml
SCHOOLBORD	SCHOOLBORD.sigml
SCHOOLREISJE	SCHOOLREISJE.sigml
SCHOOLTAS	SCHOOLTAS.sigml
SCHOON	SCHOON.sigml
SCHOONDOCHTER	SCHOONDOCHTER.sigml
SCHOONMOEDER	SCHOONMOEDER.sigml
SCHOONVADER	SCHOONVADER.sigml
SCHOONZOON	SCHOONZOON.sigml
SCHOONZUS	SCHOONZUS.sigml
SCHOORSTEEN	SCHOORSTEEN.sigml
SCHOPPEN	SCHOPPEN.sigml
SCHOUDER	SCHOUDER.sigml
SCHREEUWEN	SCHREEUWEN.sigml
SCHRIFT	SCHRIFT.sigml
SCHRIJFTOLK	SCHRIJFTOLK.sigml
SCHRIJVEN	SCHRIJVEN.sigml
SCHRIKKEN	SCHRIKKEN.sigml
SCHUDDEN	SCHUDDEN.sigml
SCHUIM	SCHUIM.sigml
SCHULD	SCHULD.sigml
SCHULDIG	SCHULDIG.sigml
SCHUUR	SCHUUR.sigml
SEIZOEN	SEIZOEN.sigml
SEPTEMBER	SEPTEMBER.sigml
SERIEUS	SERIEUS.sigml
SERVET	SERVET.sigml
SESAMSTRAAT	SESAMSTRAAT.sigml
SHAMPOO	SHAMPOO.sigml
SHOW	SHOW.sigml
SIGAAR	SIGAAR.sigml
SIGARET	SIGARET.sigml
SIMPEL	SIMPEL.sigml
SINTERKLAAS	SINTERKLAAS.sigml
SINT_MAARTEN	SINT_MAARTEN-SQ.sigml
SINT_MICHIELSGESTEL	SINT_MICHIELSGESTEL-SQ.sigml
SITUATIE	SITUATIE.sigml
SJAAL	SJAAL.sigml
SKATE	SKATE.sigml
SKATEBOARD	SKATEBOARD.sigml
SKATEBOARDEN	SKATEBOARDEN.sigml
SKEELER	SKEELER.sigml
SKELTER	SKELTER.sigml
SLA	SLA.sigml
SLAAN	SLAAN.sigml
SLAAPKAMER	SLAAPKAMER.sigml
SLAAP_LEKKER	SLAAP_LEKKER-SQ.sigml
SLAGER	SLAGER.sigml
SLAGROOM	SLAGROOM.sigml
SLANK	SLANK.sigml
SLAPEN	SLAPEN.sigml
SLECHT	SLECHT.sigml
SLECHTHOREND	SLECHTHOREND.sigml
SLEE	SLEE.sigml
SLEPEN	SLEPEN.sigml
SLEUTEL	SLEUTEL.sigml
SLIKKEN	SLIKKEN.sigml
SLIM	SLIM.sigml
SLOOM	SLOOM.sigml
SLOOT	SLOOT.sigml
SLORDIG	SLORDIG.sigml
SLOT	SLOT.sigml
SMAKELIJK	SMAKELIJK.sigml
SNAPPEN	SNAPPEN.sigml
SNEL	SNEL.sigml
SOMS	SOMS.sigml
SORRY	SORRY.sigml
SPANNEND	SPANNEND.sigml
SPAREN	SPAREN.sigml
SPECIAAL	SPECIAAL.sigml
SPEL	SPEL.sigml
SPELEN	SPELEN.sigml
SPORT	SPORT.sigml
SPRINGEN	SPRINGEN-CL{KIKKER}.sigml
SPRINGEN	SPRINGEN-CL{PAARD}.sigml
SS	SS-SP.sigml
STANDAARD_POSE	STANDAARD_POSE-GR.sigml
STEKEND	STEKEND.sigml
STER	STER.sigml
STERK	STERK.sigml
STICHTING	STICHTING.sigml
STOEL	STOEL.sigml
STOP	STOP.sigml
STRAAT	STRAAT.sigml
STRAKS	STRAKS.sigml
STREVEN	STREVEN.sigml
STUDENT	STUDENT.sigml
STUK	STUK.sigml
T	T-SP.sigml
TAAL	TAAL.sigml
TABLET	TABLET.sigml
TABLETTEN	TABLETTEN.sigml
TAFEL	TAFEL.sigml
TAS	TAS.sigml
TECHNIEK	TECHNIEK.sigml
TEGEN	TEGEN.sigml
TEGENOVER	TEGENOVER.sigml
TEKST	TEKST.sigml
TELEURGESTELD	TELEURGESTELD.sigml
TELEVISIE	TELEVISIE.sigml
TELWOORDEN	TELWOORDEN.sigml
TEL_1	TEL_1-GR.sigml
TEL_2	TEL_2-GR.sigml
TEL_3	TEL_3-GR.sigml
TEL_4	TEL_4-GR.sigml
TEL_5	TEL_5-GR.sigml
TERUG	TERUG.sigml
TEST	TEST.sigml
TE_MAKEN_MET	TE_MAKEN_MET-SQ.sigml
THEE	THEE.sigml
THUIS	THUIS.sigml
TIEN_UUR	TIEN_UUR-AM{TIJDSDUUR}.sigml
TIEN_UUR	TIEN_UUR-AM{TIJDSTIP}.sigml
TIJD	TIJD.sigml
TIJDSTIP	TIJDSTIP.sigml
TIJD_GELEDEN	TIJD_GELEDEN-SQ.sigml
TIJD_HEBBEN	TIJD_HEBBEN-AM{NEGATIE}-SQ.sigml
TIJD_HEBBEN	TIJD_HEBBEN-SQ.sigml
TIKKEN	TIKKEN.sigml
TOCH	TOCH.sigml
TOET	TOET.sigml
TOE_MAAR	TOE_MAAR-AM{NAAR_RECHTS}.sigml
TOE_MAAR	TOE_MAAR-SQ.sigml
TOLK	TOLK.sigml
TOT	TOT.sigml
TOT_NU_TOE	TOT_NU_TOE-SQ.sigml
TOT_ZIENS	TOT_ZIENS-SQ.sigml
TREIN	TREIN.sigml
TROEP	TROEP.sigml
TROUWEN	TROUWEN.sigml
TT	TT-SP.sigml
TUSSEN	TUSSEN.sigml
TWEEDE	TWEEDE.sigml
TWEE_UUR	TWEE_UUR-AM{TIJDSDUUR}.sigml
TWEE_UUR	TWEE_UUR-AM{TIJDSTIP}.sigml
TWIJFELEN	TWIJFELEN.sigml
U	U-SP.sigml
U	U.sigml
UITADEMEN	UITADEMEN.sigml
UITBLAZEN	UITBLAZEN-AM{ADEM}.sigml
UITBLAZEN	UITBLAZEN-AM{KAARS}.sigml
UITDOEN	UITDOEN-CL{LAMP}.sigml
UITGAAN	UITGAAN.sigml
UITGEVEN	UITGEVEN-CL{BOEK}.sigml
UITLEG	UITLEG.sigml
UITLEGGEN	UITLEGGEN.sigml
UITPAKKEN	UITPAKKEN.sigml
UITSLAG	UITSLAG.sigml
UITSLAGEN	UITSLAGEN.sigml
UIT_ELKAAR_GAAN	UIT_ELKAAR_GAAN-SQ.sigml
UTRECHT	UTRECHT.sigml
UU	UU-SP.sigml
UUR	UUR.sigml
V	V-SP.sigml
VAAG	VAAG.sigml
VAAK	VAAK.sigml
VAARDIGHEID	VAARDIGHEID.sigml
VAAS	VAAS.sigml
VADER	VADER.sigml
VAGINA	VAGINA.sigml
VAK	VAK-AM{POSTVAK}.sigml
VAK	VAK-AM{SCHOOLVAK}.sigml
VAK	VAK-AM{WINKEL}.sigml
VAKANTIE	VAKANTIE.sigml
VALLEN	VALLEN.sigml
VAN	VAN-CL{JOU}.sigml
VAN	VAN-CL{MIJ}.sigml
VAN	VAN.sigml
VANAF	VANAF.sigml
VANAVOND	VANAVOND.sigml
VANDAAG	VANDAAG.sigml
VANDAAR	VANDAAR.sigml
VANGEN	VANGEN.sigml
VANMIDDAG	VANMIDDAG.sigml
VANOCHTEND	VANOCHTEND.sigml
VANZELF	VANZELF.sigml
VANZELFSPREKEND	VANZELFSPREKEND.sigml
VAN_REPLIEK_DIENEN	VAN_REPLIEK_DIENEN-SQ.sigml
VAREN	VAREN.sigml
VARKEN	VARKEN.sigml
VARKENSVLEES	VARKENSVLEES.sigml
VAST	VAST-AM{ONVERANDERLIJK}.sigml
VASTBINDEN	VASTBINDEN.sigml
VASTEN	VASTEN.sigml
VASTENPERIODE	VASTENPERIODE.sigml
VASTHOUDEN	VASTHOUDEN.sigml
VASTLEGGEN_OP_PAPIER	VASTLEGGEN_OP_PAPIER-SQ.sigml
VASTSTELLEN	VASTSTELLEN.sigml
VECHTEN	VECHTEN.sigml
VEEL	VEEL.sigml
VEEL_VERSTAND_HEBBEN	VEEL_VERSTAND_HEBBEN-SQ.sigml
VEGANISTISCH	VEGANISTISCH.sigml
VEGEN	VEGEN-CL{BEZEM}.sigml
VEGEN	VEGEN-CL{STOFFER_EN_BLIK}.sigml
VEGETARISCH	VEGETARISCH.sigml
VEILIG	VEILIG.sigml
VELD	VELD.sigml
VENSTERBANK	VENSTERBANK.sigml
VER	VER-AM{WEG}.sigml
VERANDEREN	VERANDEREN.sigml
VERANDERING	VERANDERING.sigml
VERANTWOORDELIJK	VERANTWOORDELIJK.sigml
VERBAND	VERBAND.sigml
VERBERGEN	VERBERGEN.sigml
VERBETERD	VERBETERD.sigml
VERBETEREN	VERBETEREN.sigml
VERBINDEN	VERBINDEN.sigml
VERBLIJF	VERBLIJF.sigml
VERBODEN	VERBODEN.sigml
VERBRANDEN	VERBRANDEN.sigml
VERDELEN	VERDELEN.sigml
VERDELING	VERDELING.sigml
VERDER	VERDER-AM{AFSTAND}.sigml
VERDER	VERDER.sigml
VERDIENEN	VERDIENEN-CL{GELD}.sigml
VERDOEZELEN	VERDOEZELEN.sigml
VERDOVEN	VERDOVEN.sigml
VERDOVING	VERDOVING.sigml
VERDRIETIG	VERDRIETIG.sigml
VERENIGING	VERENIGING.sigml
VERF	VERF.sigml
VERGADERING	VERGADERING.sigml
VERGELIJKEN	VERGELIJKEN.sigml
VERGETEN	VERGETEN.sigml
VERGISSEN	VERGISSEN.sigml
VERGISSING	VERGISSING.sigml
VERHAAL	VERHAAL.sigml
VERHEUGEN	VERHEUGEN.sigml
VERHOGEN	VERHOGEN.sigml
VERHOGING	VERHOGING.sigml
VERHOUDING	VERHOUDING.sigml
VERHUIZEN	VERHUIZEN.sigml
VERHUREN	VERHUREN.sigml
VERJAARDAG	VERJAARDAG.sigml
VERJAARDAGSFEEST	VERJAARDAGSFEEST.sigml
VERKEER	VERKEER.sigml
VERKEERD	VERKEERD.sigml
VERKERING	VERKERING.sigml
VERKIEZING	VERKIEZING.sigml
VERKLAPPEN	VERKLAPPEN.sigml
VERKLAREN	VERKLAREN.sigml
VERKLARING	VERKLARING-AM{BEWIJS}.sigml
VERKLARING	VERKLARING-AM{UITLEG}.sigml
VERKLEDEN	VERKLEDEN.sigml
VERKOPEN	VERKOPEN.sigml
VERKOUDEN	VERKOUDEN.sigml
VERLANGEN	VERLANGEN.sigml
VERLANGLIJST	VERLANGLIJST.sigml
VERLATEN	VERLATEN.sigml
VERLEDEN	VERLEDEN.sigml
VERLEGEN	VERLEGEN.sigml
VERLENEN	VERLENEN.sigml
VERLENING	VERLENING.sigml
VERLIEFD	VERLIEFD.sigml
VERLIEZEN	VERLIEZEN-CL{VOORWERP}.sigml
VERLIEZEN	VERLIEZEN-CL{WEDSTRIJD}.sigml
VERMENIGVULDIGEN	VERMENIGVULDIGEN.sigml
VERMOEDEN	VERMOEDEN.sigml
VERONTSCHULDIGEN	VERONTSCHULDIGEN.sigml
VERPLEEGKUNDIGE	VERPLEEGKUNDIGE.sigml
VERPLEEGSTER	VERPLEEGSTER.sigml
VERPLEGEN	VERPLEGEN.sigml
VERRADEN	VERRADEN.sigml
VERRASSING	VERRASSING.sigml
VERSCHEIDENE	VERSCHEIDENE.sigml
VERSCHIJNEN	VERSCHIJNEN-CL{BEELD_OP_TV}.sigml
VERSCHIJNEN	VERSCHIJNEN-CL{PERSOON}.sigml
VERSCHIL	VERSCHIL.sigml
VERSCHILLEN	VERSCHILLEN.sigml
VERSCHILLEND	VERSCHILLEND.sigml
VERSCHILLENDE	VERSCHILLENDE.sigml
VERSIEREN	VERSIEREN-CL{IEMAND}.sigml
VERSIEREN	VERSIEREN-CL{IETS}.sigml
VERSLAAN	VERSLAAN.sigml
VERSLECHTERD	VERSLECHTERD.sigml
VERSTAND	VERSTAND.sigml
VERSTANDIG	VERSTANDIG.sigml
VERSTERKEN	VERSTERKEN.sigml
VERSTOPPEN	VERSTOPPEN.sigml
VERSTOPPER	VERSTOPPER.sigml
VERSTOPPERTJE	VERSTOPPERTJE.sigml
VERTALEN	VERTALEN.sigml
VERTALING	VERTALING.sigml
VERTE	VERTE.sigml
VERTEGENWOORDIGER	VERTEGENWOORDIGER.sigml
VERTELLEN	VERTELLEN-DI{2_1}.sigml
VERTELLEN	VERTELLEN.sigml
VERTRAAGD	VERTRAAGD.sigml
VERTRAGING	VERTRAGING.sigml
VERTREKKEN	VERTREKKEN.sigml
VERTROUWD	VERTROUWD.sigml
VERTROUWEN	VERTROUWEN.sigml
VERVANGEN	VERVANGEN.sigml
VERVELEN	VERVELEN.sigml
VERVELEND	VERVELEND.sigml
VERVEN	VERVEN.sigml
VERVOER	VERVOER.sigml
VERVOLG	VERVOLG.sigml
VERVUILING	VERVUILING.sigml
VERVULLEN	VERVULLEN-AM{WENS}.sigml
VERWAAND	VERWAAND.sigml
VERWACHTEN	VERWACHTEN.sigml
VERWARD	VERWARD.sigml
VERWARMING	VERWARMING.sigml
VERWENNEN	VERWENNEN.sigml
VERWIJDEREN	VERWIJDEREN-CL{ORGAAN}.sigml
VERWIJDEREN	VERWIJDEREN.sigml
VERZAMELEN	VERZAMELEN-CL{PERSONEN}.sigml
VERZAMELEN	VERZAMELEN-CL{SPULLEN}.sigml
VERZEKERD	VERZEKERD.sigml
VERZEKERING	VERZEKERING.sigml
VERZET	VERZET.sigml
VERZETTEN	VERZETTEN-AM{TIJD}.sigml
VERZINNEN	VERZINNEN.sigml
VERZOEK	VERZOEK.sigml
VERZORGEN	VERZORGEN.sigml
VETER	VETER.sigml
VIA	VIA.sigml
VIDEO	VIDEO.sigml
VIDEOBAND	VIDEOBAND.sigml
VIDEOBELLEN	VIDEOBELLEN.sigml
VIDEOCAMERA	VIDEOCAMERA.sigml
VIDEOFILM	VIDEOFILM.sigml
VIDEORECORDER	VIDEORECORDER.sigml
VIERKANT	VIERKANT.sigml
VIERKANTE_METER	VIERKANTE_METER-SQ.sigml
VIER_UUR	VIER_UUR-AM{TIJDSDUUR}.sigml
VIER_UUR	VIER_UUR-AM{TIJDSTIP}.sigml
VIES	VIES.sigml
VIJAND	VIJAND.sigml
VIJF_UUR	VIJF_UUR-AM{TIJDSDUUR}.sigml
VIJF_UUR	VIJF_UUR-AM{TIJDSTIP}.sigml
VIJVER	VIJVER.sigml
VINDEN	VINDEN.sigml
VINGER	VINGER.sigml
VINGERORIENTATIE	VINGERORIENTATIE.sigml
VINGERSPELLEN	VINGERSPELLEN.sigml
VINGERSPELLING	VINGERSPELLING.sigml
VIRUS	VIRUS.sigml
VIS	VIS-AM{DIER}.sigml
VIS	VIS-AM{ETEN}.sigml
VISSEN	VISSEN.sigml
VLA	VLA.sigml
VLAG	VLAG.sigml
VLAK	VLAK.sigml
VLEES	VLEES.sigml
VLEK	VLEK.sigml
VLIEG	VLIEG.sigml
VLIEGEN	VLIEGEN-CL{DIEREN}.sigml
VLIEGEN	VLIEGEN-CL{VLIEGTUIG}.sigml
VLIEGER	VLIEGER.sigml
VLIEGEREN	VLIEGEREN.sigml
VLIEGTUIG	VLIEGTUIG.sigml
VLIEGVELD	VLIEGVELD.sigml
VLINDER	VLINDER.sigml
VLOER	VLOER.sigml
VLUCHTEN	VLUCHTEN.sigml
VLUG	VLUG.sigml
VOCHT	VOCHT.sigml
VOELEN	VOELEN.sigml
VOER	VOER.sigml
VOEREN	VOEREN-CL{DIEREN}.sigml
VOEREN	VOEREN-CL{KIND}.sigml
VOETBAL	VOETBAL.sigml
VOETBALLEN	VOETBALLEN.sigml
VOETEN	VOETEN.sigml
VOGEL	VOGEL.sigml
VOL	VOL-AM{PERSOON}.sigml
VOLDAAN	VOLDAAN.sigml
VOLGEN	VOLGEN-AM{ACHTERVOLGEN}.sigml
VOLGEN	VOLGEN-AM{OPLEIDING}.sigml
VOLGENDE	VOLGENDE.sigml
VOLGENS	VOLGENS.sigml
VOLGORDE	VOLGORDE.sigml
VOLHOUDEN	VOLHOUDEN.sigml
VOLK	VOLK.sigml
VOLLEDIG	VOLLEDIG.sigml
VOLWASSENE	VOLWASSENE.sigml
VOOR	VOOR-AM{DOEL}.sigml
VOOR	VOOR-AM{PLAATS}.sigml
VOOR	VOOR-AM{TIJD}.sigml
VOORAL	VOORAL.sigml
VOORBEELD	VOORBEELD.sigml
VOORBIJ	VOORBIJ.sigml
VOORDEEL	VOORDEEL.sigml
VOORKOMEN	VOORKOMEN.sigml
VOORLEZEN	VOORLEZEN.sigml
VOORLOPIG	VOORLOPIG.sigml
VOORNAAM	VOORNAAM.sigml
VOORNAMELIJK	VOORNAMELIJK.sigml
VOORSTANDER	VOORSTANDER.sigml
VOORSTEL	VOORSTEL.sigml
VOORSTELLEN	VOORSTELLEN-CL{JEZELF}.sigml
VOORSTELLEN	VOORSTELLEN-CL{PERSOON}.sigml
VOORSTELLING	VOORSTELLING.sigml
VOORTDUREND	VOORTDUREND.sigml
VOORUIT	VOORUIT.sigml
VOORWERP	VOORWERP.sigml
VOORZICHTIG	VOORZICHTIG.sigml
VOOR_ELKAAR	VOOR_ELKAAR-SQ.sigml
VORIG	VORIG.sigml
VORIGE	VORIGE.sigml
VORK	VORK.sigml
VORM	VORM.sigml
VRAAG	VRAAG.sigml
VRACHTWAGEN	VRACHTWAGEN.sigml
VRAGEN	VRAGEN.sigml
VREDE	VREDE.sigml
VREEMD	VREEMD.sigml
VRESELIJK	VRESELIJK.sigml
VREUGDE	VREUGDE.sigml
VRIEND	VRIEND-AM{ROMANTISCH}.sigml
VRIEND	VRIEND-AM{VRIENDSCHAP}.sigml
VRIENDELIJK	VRIENDELIJK.sigml
VRIENDIN	VRIENDIN-AM{ROMANTISCH}.sigml
VRIENDIN	VRIENDIN-AM{VRIENDSCHAP}.sigml
VRIEZEN	VRIEZEN.sigml
VRIJ	VRIJ-AM{GEVANGENSCHAP}.sigml
VRIJDAG	VRIJDAG.sigml
VRIJEN	VRIJEN.sigml
VRIJE_TIJD	VRIJE_TIJD-SQ.sigml
VROEG	VROEG.sigml
VROEGER	VROEGER.sigml
VROLIJK	VROLIJK.sigml
VROUW	VROUW-AM{GESLACHT}.sigml
VROUW	VROUW-AM{PARTNER}.sigml
VRUCHTBAAR	VRUCHTBAAR.sigml
VRUCHTEN	VRUCHTEN.sigml
VUIL	VUIL.sigml
VUILCONTAINER	VUILCONTAINER.sigml
VUILNIS	VUILNIS.sigml
VUILNISZAK	VUILNISZAK.sigml
VUUR	VUUR.sigml
VUURTOREN	VUURTOREN.sigml
VUURWERK	VUURWERK.sigml
VV	VV-SP.sigml
W	W-SP.sigml
WAAIEN	WAAIEN.sigml
WAAR	WAAR.sigml
WAARDELOOS	WAARDELOOS.sigml
WAARDEREN	WAARDEREN.sigml
WAARDERING	WAARDERING.sigml
WAARHEID	WAARHEID.sigml
WAARMAKEN	WAARMAKEN.sigml
WAAROM	WAAROM.sigml
WAARSCHIJNLIJK	WAARSCHIJNLIJK.sigml
WAARSCHUWEN	WAARSCHUWEN.sigml
WAARVOOR	WAARVOOR.sigml
WACHTEN	WACHTEN.sigml
WACHTKAMER	WACHTKAMER.sigml
WAF	WAF.sigml
WAKKER	WAKKER.sigml
WANG	WANG.sigml
WANNEER	WANNEER.sigml
WANTEN	WANTEN.sigml
WARM	WARM.sigml
WASGOED	WASGOED.sigml
WASMACHINE	WASMACHINE.sigml
WASSEN	WASSEN-CL{KLEDING}.sigml
WASSEN	WASSEN-CL{PERSOON}.sigml
WASSEN	WASSEN.sigml
WASTAFEL	WASTAFEL.sigml
WAT	WAT.sigml
WATER	WATER.sigml
WATERVAL	WATERVAL.sigml
WC	WC-PAPIER.sigml
WC	WC.sigml
WEBPAGINA	WEBPAGINA.sigml
WEBSITE	WEBSITE.sigml
WEDSTRIJD	WEDSTRIJD.sigml
WEEGSCHAAL	WEEGSCHAAL.sigml
WEEK	WEEK.sigml
WEEKEND	WEEKEND.sigml
WEER	WEER.sigml
WEERWOORD	WEERWOORD.sigml
WEG	WEG.sigml
WEGBRENGEN	WEGBRENGEN.sigml
WEGEN	WEGEN.sigml
WEGGAAN	WEGGAAN.sigml
WEGTREKKEN	WEGTREKKEN.sigml
WEINIG	WEINIG.sigml
WEKEN	WEKEN.sigml
WEKKER	WEKKER.sigml
WELKE	WELKE-AM{VAN_DE_TWEE}.sigml
WELKE	WELKE.sigml
WELKOM	WELKOM.sigml
WENNEN	WENNEN.sigml
WENS	WENS.sigml
WENSEN	WENSEN.sigml
WERELD	WERELD.sigml
WERK	WERK.sigml
WERKEN	WERKEN.sigml
WERKLOOS	WERKLOOS.sigml
WERKWOORD	WERKWOORD.sigml
WESP	WESP.sigml
WEST	WEST.sigml
WETEN	WETEN.sigml
WIE	WIE.sigml
WIEBELEN	WIEBELEN.sigml
WIJ	WIJ-AM{TWEE}.sigml
WIJ	WIJ.sigml
WIJN	WIJN.sigml
WIJS	WIJS.sigml
WILD	WILD.sigml
WILLEM_ALEXANDER	WILLEM_ALEXANDER-SQ.sigml
WILLEN	WILLEN.sigml
WIND	WIND-AM{SCHEET}.sigml
WIND	WIND-AM{WEER}.sigml
WINKEL	WINKEL.sigml
WINKELWAGEN	WINKELWAGEN.sigml
WINNEN	WINNEN.sigml
WINTER	WINTER.sigml
WINTERJAS	WINTERJAS.sigml
WINTERSPORT	WINTERSPORT.sigml
WINTERTIJD	WINTERTIJD.sigml
WIP	WIP.sigml
WIPPEN	WIPPEN.sigml
WOEDEND	WOEDEND.sigml
WOELEN	WOELEN.sigml
WOENSDAG	WOENSDAG.sigml
WOLKEN	WOLKEN.sigml
WONEN	WONEN.sigml
WOONKAMER	WOONKAMER.sigml
WOORD	WOORD.sigml
WREED	WREED.sigml
WW	WW-SP.sigml
X	X-SP.sigml
Y	Y-SP.sigml
YOGHURT	YOGHURT.sigml
YY	YY-SP.sigml
Z	Z-SP.sigml
ZAAL	ZAAL.sigml
ZACHT	ZACHT.sigml
ZAK	ZAK.sigml
ZAKDOEK	ZAKDOEK.sigml
ZAKGELD	ZAKGELD.sigml
ZAKKEN	ZAKKEN.sigml
ZALF	ZALF.sigml
ZAND	ZAND.sigml
ZANDBAK	ZANDBAK.sigml
ZAT	ZAT.sigml
ZATERDAG	ZATERDAG.sigml
ZEBRA	ZEBRA.sigml
ZEBRAPAD	ZEBRAPAD.sigml
ZEE	ZEE.sigml
ZEEHOND	ZEEHOND.sigml
ZEELAND	ZEELAND.sigml
ZEEP	ZEEP.sigml
ZEESTER	ZEESTER.sigml
ZEGGEN	ZEGGEN.sigml
ZEILBOOT	ZEILBOOT.sigml
ZEKER	ZEKER.sigml
ZELF	ZELF.sigml
ZELFSTANDIG	ZELFSTANDIG.sigml
ZELFVERTROUWEN	ZELFVERTROUWEN.sigml
ZELF_WETEN	ZELF_WETEN-SQ.sigml
ZEMEN	ZEMEN.sigml
ZENUWACHTIG	ZENUWACHTIG.sigml
ZES_UUR	ZES_UUR-AM{TIJDSDUUR}.sigml
ZES_UUR	ZES_UUR-AM{TIJDSTIP}.sigml
ZEUREN	ZEUREN.sigml
ZEURPIET	ZEURPIET.sigml
ZEVEN_UUR	ZEVEN_UUR-AM{TIJDSDUUR}.sigml
ZEVEN_UUR	ZEVEN_UUR-AM{TIJDSTIP}.sigml
ZIEK	ZIEK.sigml
ZIEKENAUTO	ZIEKENAUTO.sigml
ZIEKENHUIS	ZIEKENHUIS.sigml
ZIEKENWAGEN	ZIEKENWAGEN.sigml
ZIELIG	ZIELIG.sigml
ZIJ	ZIJ-AM{ALLEMAAL}.sigml
ZIJKANT	ZIJKANT-CL{HUIS}.sigml
ZILVER	ZILVER.sigml
ZIN	ZIN-AM{REGEL}.sigml
ZINGEN	ZINGEN.sigml
ZIN_HEBBEN	ZIN_HEBBEN.sigml
ZIN_HEBBEN_ETEN	ZIN_HEBBEN_ETEN.sigml
ZITTEN	ZITTEN-CL{HEK}.sigml
ZITTEN	ZITTEN-CL{PAARD}.sigml
ZITTEN	ZITTEN.sigml
ZOEKEN	ZOEKEN.sigml
ZOET	ZOET.sigml
ZOLDER	ZOLDER.sigml
ZOMER	ZOMER.sigml
ZOMERHUIS	ZOMERHUIS.sigml
ZOMERTIJD	ZOMERTIJD.sigml
ZOMERVAKANTIE	ZOMERVAKANTIE.sigml
ZON	ZON.sigml
ZONDAG	ZONDAG.sigml
ZONDE	ZONDE.sigml
ZONNEBRIL	ZONNEBRIL.sigml
ZONSONDERGANG	ZONSONDERGANG.sigml
ZONSOPGANG	ZONSOPGANG.sigml
ZOON	ZOON.sigml
ZORGEN	ZORGEN.sigml
ZOUT	ZOUT.sigml
ZUID	ZUID-HOLLAND.sigml
ZUID	ZUID.sigml
ZUINIG	ZUINIG.sigml
ZUS	ZUS.sigml
ZUUR	ZUUR.sigml
ZUURKOOL	ZUURKOOL.sigml
ZUURSTOF	ZUURSTOF.sigml
ZWAAIEN	ZWAAIEN.sigml
ZWAAR	ZWAAR.sigml
ZWAARD	ZWAARD.sigml
ZWAGER	ZWAGER.sigml
ZWART	ZWART-AM{HUIDSKLEUR}.sigml
ZWARTE_PIET	ZWARTE_PIET-SQ.sigml
ZWEMBAD	ZWEMBAD.sigml
ZWEMBAND	ZWEMBAND.sigml
ZWEMMEN	ZWEMMEN.sigml
ZZ	ZZ-SP.sigml
